ÉÍÍÍÍÍÍÍÍÍÍÍÍ¸ÕÍÍÍÍÍÍÍÍÍÍÍÍ»
÷שששששששששששש³³שששששששששששש÷
÷שÚÄÄ¿שÚÄÄÄ¿ש³³שÚÄÄÄ¿שÚÄÄ¿ש÷
÷‏³  ³ש³   ³ש³³ש³   ³ש³  ³‏÷
÷שÀÄÄÙשÀÄÄÄÙשÀÙשÀÄÄÄÙשÀÄÄÙש÷
÷שששששששששששששששששששששששששש÷
÷שÚÄÄ¿שÚ¿שÚÄÄÄÄÄÄ¿שÚ¿שÚÄÄ¿ש÷
÷שÀÄÄÙש³³שÀÄÄ¿ÚÄÄÙש³³שÀÄÄÙש÷
÷שששששש³³שששש³³שששש³³שששששש÷
ÈÍÍÍÍ»ש³ÀÄÄ¿ ³³ ÚÄÄÙ³שÉÍÍÍÍ¼
     ÷ש³ÚÄÄÙ ÀÙ ÀÄÄ¿³ש÷     
     ÷ש³³          ³³ש÷     
     ÷ש³³ ÉÍÍננÍÍ» ³³ש÷     
ÍÍÍÍÍ¼שÀÙ ÷      ÷ ÀÙשÈÍÍÍÍÍ
      ש   ÷      ÷   ש      
ÍÍÍÍÍ»שÚ¿ ÷      ÷ Ú¿שÉÍÍÍÍÍ
     ÷ש³³ ÈÍÍÍÍÍÍ¼ ³³ש÷     
     ÷ש³³          ³³ש÷     
     ÷ש³³ ÚÄÄÄÄÄÄ¿ ³³ש÷     
ÉÍÍÍÍ¼שÀÙ ÀÄÄ¿ÚÄÄÙ ÀÙשÈÍÍÍÍ»
÷שששששששששששש³³שששששששששששש÷
÷שÚÄÄ¿שÚÄÄÄ¿ש³³שÚÄÄÄ¿שÚÄÄ¿ש÷
÷שÀÄ¿³שÀÄÄÄÙשÀÙשÀÄÄÄÙש³ÚÄÙש÷
÷‏שש³³ששששששש  ששששששש³³שש‏÷
ÓÄ¿ש³³שÚ¿שÚÄÄÄÄÄÄ¿שÚ¿ש³³שÚÄ½
ÖÄÙשÀÙש³³שÀÄÄ¿ÚÄÄÙש³³שÀÙשÀÄ·
÷שששששש³³שששש³³שששש³³שששששש÷
÷שÚÄÄÄÄÙÀÄÄ¿ש³³שÚÄÄÙÀÄÄÄÄ¿ש÷
÷שÀÄÄÄÄÄÄÄÄÙשÀÙשÀÄÄÄÄÄÄÄÄÙש÷
÷שששששששששששששששששששששששששש÷
ÈÍÍÍÍÍÍÍÍÍÍÍÍÍÍÍÍÍÍÍÍÍÍÍÍÍÍ¼
