14 21x15 ABOUT="Inspired by Carey Nachenberg/Carey Nash's 'Ack! Man'" NOTE="some doors were added to make levels possible" FIXME="some of the tunnels do not work because they are misaligned" RGHOST=5.5,5.5,1.5,1.5,7.5,7.5,7.5,7.5,1.5,1.5,7.5,7.5,7.5,7.5 ROGHOST=0 COGHOST=2,2,1,1,1,1,2,2,1,1,1,1,2,2 RTOP=5.5,5.5,2.5,2.5,7.5,7.5,7.5,7.5,2.5,2.5,7.5,7.5,7.5,7.5 RHERO=7.5,7.5,7.5,7.5,9.5,9.5,11.5,11.5,7.5,7.5,9.5,9.5,11.5,11.5 RFRUIT=7.5,7.5,7.5,7.5,9.5,9.5,11.5,11.5,7.5,7.5,9.5,9.5,11.5,11.5 RMSG=14 CMSG=5 RMSG2=0 CMSG2=5 READY="  READY!!  " PLAYER1=" PLAYER ONE" PLAYER2=" PLAYER TWO" GAMEOVER=" GAME OVER " WALL_COLORS="\x0F" MORTAR_COLORS="\x08" DOT_COLORS="\x0F" PELLET_COLORS="\x0A"
╔═══════════════════╗
║■·················■║
║·╔══════╡·╞══════╗·║
║·║···············║·║
║·╨·╥·╔═══≡═══╗·╥·╨·║
║···║·║       ║·║···║
╝·╞═╝·╚═══════╝·╚═╡·╚
 ········· ········· 
╗·╞═╗·╞═══════╡·╔═╡·╔
║···║···········║···║
║·╥·╨·╞══╗·╔══╡·╨·╥·║
║·║······║·║······║·║
║·╚════╡·╨·╨·╞════╝·║
║■·················■║
╚═══════════════════╝
╔═══════════════════╗
║■·················■║
║·╔══════╡·╞══════╗·║
║·║···············║·║
║·╨·╥·╔═══≡═══╗·╥·╨·║
║···║·║       ║·║···║
╝·╞═╝·╚═══════╝·╚═╡·╚
 ········· ········· 
╗·╞═╗·╞═══════╡·╔═╡·╔
║···║···········║···║
║·╥·╨·╞══╗·╔══╡·╨·╥·║
║·║······║·║······║·║
║·╚════╡·╨·╨·╞════╝·║
║■·················■║
╚═══════════════════╝
╞═══════╦═══╦═══════╗
 ·■·····l   l·····■·║
╥·╞═══╗·╚═≡═╝·╔═══╡·║
║·····║·······║·····║
║·╔═╡·║·╞═══╡·║·╞═╗·║
║·║···║·······║···║·║
║·╨·╞═╝·╞═══╡·╚═╡·╨·║
║········· ·········║
║·╔══════╡·╞══════╗·║
║·║···············║·║
║·║·╞═══╡·╥·╞═══╡·║·║
║·║···■···║···■···║·║
║·╨·╞═══╡·╨·╞═══╡·╨·╨
║··················· 
╚═══════════════════╡
╞═══════╦═══╦═══════╗
 ·■·····l   l·····■·║
╥·╞═══╗·╚═≡═╝·╔═══╡·║
║·····║·······║·····║
║·╔═╡·║·╞═══╡·║·╞═╗·║
║·║···║·······║···║·║
║·╨·╞═╝·╞═══╡·╚═╡·╨·║
║········· ·········║
║·╔══════╡·╞══════╗·║
║·║···············║·║
║·║·╞═══╡·╥·╞═══╡·║·║
║·║···■···║···■···║·║
║·╨·╞═══╡·╨·╞═══╡·╨·╨
║··················· 
╚═══════════════════╡
╔═══════════════════╡
║■·················· 
║·╥·╞═══════════╡·╥·╥
║·║···············║·║
║·╨·╞═╦══╡ ╞══╦═╡·╨·║
║·····║·······║·····║
║·╥·╥·╨·╔═≡═╗·╨·╥·╥·║
║·║■║···║   ║···║■║·║
║·╨·╨·╥·╚═══╝·╥·╨·╨·║
║·····║··· ···║·····║
║·╥·╞═╩══╡ ╞══╩═╡·╥·║
║·║···············║·║
╨·╨·╞═══════════╡·╨·║
 ··················■║
╞═══════════════════╝
╔═══════════════════╡
║■·················· 
║·╥·╞═══════════╡·╥·╥
║·║···············║·║
║·╨·╞═╦══╡ ╞══╦═╡·╨·║
║·····║·······║·····║
║·╥·╥·╨·╔═≡═╗·╨·╥·╥·║
║·║■║···║   ║···║■║·║
║·╨·╨·╥·╚═══╝·╥·╨·╨·║
║·····║··· ···║·····║
║·╥·╞═╩══╡ ╞══╩═╡·╥·║
║·║···············║·║
╨·╨·╞═══════════╡·╨·║
 ··················■║
╞═══════════════════╝
╔═══════════════════╗
║·········■·········║
║·╞═╦════╡·╞════╦═╡·║
║···╨···········╨···║
║·╥···╞═══════╡···╥·║
╨·╚═╡···········╞═╝·║
 ·····╔═══≡═══╗·····║
╔~════╣       ╠════~╝
║·····╚═══≡═══╝····· 
║·╔═╡···········╞═╗·╥
║·║···╞═══════╡···║·║
║·║·╥····· ·····╥·║·║
║·╨·╚════╡·╞════╝·╨·║
║■·················■║
╚═══════════════════╝
╔═══════════════════╗
║■·················■║
║·╞═╦════╡·╞════╦═╡·║
║···╨···········╨···║
║·╥···╞═══════╡···╥·║
╨·╚═╡···········╞═╝·║
 ·····╔═══≡═══╗·····║
╔~════╣       ╠════~╝
║·····╚═══≡═══╝····· 
║·╔═╡···········╞═╗·╥
║·║···╞═══════╡···║·║
║·║·╥····· ·····╥·║·║
║·╨·╚════╡·╞════╝·╨·║
║·········■·········║
╚═══════════════════╝
╞═══════╦═══╦═══════╗
 ·······l   l·······║
╥·╞═══╗·╚═≡═╝·╔═══╡·║
║·····║···■···║·····║
║·╔═╡·║·╞═══╡·║·╞═╗·║
║·║···║·······║···║·║
║·╨·╞═╝·╞═══╡·╚═╡·╨·║
║········· ·········║
║·╔══════╡·╞══════╗·║
║·║···············║·║
║·║·╞═══╡·╥·╞═══╡·║·║
║·║···■···║···■···║·║
║·╨·╞═══╡·╨·╞═══╡·╨·╨
║··················· 
╚═══════════════════╡
╞═══════╦═══╦═══════╗
 ·······l   l······■║
╥·╞═══╗·╚═≡═╝·╔═══╡·║
║·····║···■···║·····║
║·╔═╡·║·╞═══╡·║·╞═╗·║
║·║···║·······║···║·║
║·╨·╞═╝·╞═══╡·╚═╡·╨·║
║········· ·········║
║·╔══════╡·╞══════╗·║
║·║···············║·║
║·║·╞═══╡·╥·╞═══╡·║·║
║·║·······║·······║·║
║·╨·╞═══╡·╨·╞═══╡·╨·╨
║■·················· 
╚═══════════════════╡
╔═══════════════════╡
║··················· 
║·╥·╞═══════════╡·╥·╥
║·║··············■║·║
║·╨·╞═╦══╡ ╞══╦═╡·╨·║
║·····║···■···║·····║
║·╥·╥·╨·╔═≡═╗·╨·╥·╥·║
║·║·║···║   ║···║·║·║
║·╨·╨·╥·╚═══╝·╥·╨·╨·║
║·····║··· ···║·····║
║·╥·╞═╩══╡ ╞══╩═╡·╥·║
║·║■··············║·║
╨·╨·╞═══════════╡·╨·║
 ···················║
╞═══════════════════╝
╔═══════════════════╗
║·········■·········╨
║·╥·╞═══════════╡·╥· 
║·║···············║·╥
║·╨·╞═╦══╡ ╞══╦═╡·╨·║
║·····║·······║·····║
║·╥·╥·╨·╔═≡═╗·╨·╥·╥·║
║·║·║···║   ║···║·║·║
║·╨·╨·╥·╚═══╝·╥·╨·╨·║
║·····║··· ···║·····║
║·╥·╞═╩══╡ ╞══╩═╡·╥·║
╨·║···············║·║
 ·╨·╞═══════════╡·╨·║
╥·········■·········║
╚═══════════════════╝
╔═══════════════════╗
║·········■·········║
║·╞═╦════╡·╞════╦═╡·║
║···╨···········╨···║
║·╥···╞═══════╡···╥·║
╨·╚═╡···········╞═╝·║
 ·····╔═══≡═══╗·····║
╔~════╣       ╠════~╝
║·····╚═══≡═══╝····· 
║·╔═╡···········╞═╗·╥
║·║···╞═══════╡···║·║
║·║·╥····· ·····╥·║·║
║·╨·╚════╡·╞════╝·╨·║
║■·················■║
╚═══════════════════╝
╔═══════════════════╗
║■·················■║
║·╞═╦════╡·╞════╦═╡·║
║···╨···········╨···║
║·╥···╞═══════╡···╥·║
╨·╚═╡···········╞═╝·║
 ·····╔═══≡═══╗·····║
╔~════╣       ╠════~╝
║·····╚═══≡═══╝····· 
║·╔═╡···········╞═╗·╥
║·║···╞═══════╡···║·║
║·║·╥····· ·····╥·║·║
║·╨·╚════╡·╞════╝·╨·║
║·········■·········║
╚═══════════════════╝
