3 19x22~4 RGHOST=8.5,9.5,9.5 COGHOST=1 CMSG=6 CMSG2=6 WALL_COLORS="\x07\x02\x0B" MORTAR_COLORS="\x02\x0B\x07" DOT_COLORS="\x0F" ROGHOST=1 RFRUIT=10.5,11.5,11.5 RTOP=7.5,8.5,8.5 RHERO=14.5,13.5,15.5 RMSG=10,11,11 RMSG2=6,7,7 READY=" READY!" PLAYER1=" P ONE " PLAYER2=" P TWO " GAMEOVER="GOODBYE" ABOUT="Inspired by Bally's 'Baby Pac-Man' pinball machine" NOTE="this does not include a pinball simulator (maze slightly reduced)"
╔═════════════════╗
║·················║
║·╔═╡·╞══╦══╡·╞═╗·║
║·║······║······║·║
║■╨·╞╗·╥·║·╥·╔╡·╨■║
║····║·╨·╨·╨·║····║
╚══╗·║       ║·╔══╝
═══╝·╨ ╔═≡═╗ ╨·╚═══
    ·  ║   ║  ·    
═══╗·╥ ╚═══╝ ╥·╔═══
╔══╝·║       ║·╚══╗
║····╠═╡ ╥ ╞═╣····║
║·┌┐·║···║···║·┌┐·║
║·╓┘·╨·╞═╩═╡·╨·└╖·║
║·║······ ······║·║
║■╨·╞══╡·╥·╞══╡·╨■║
║········║········║
║·╥·╥ ╥·┌╨┐·╥ ╥·╥·║
║·╨·║ ║·└─┘·║ ║·╨·║
║···║ ║·····║ ║···║
╚═══╣ ╠═════╣ ╠═══╝
    ║»║     ║«║    
╔═════════════════╗
║·················║
║·╞══╡·╔═══╗·╞══╡·║
║······║···║······║
║·╔══╡·╨·╥·╨·╞══╗·║
║■║······║······║■║
║·╨·╞╗ ╞═╩═╡ ╔╡·╨·║
║····║       ║····║
╩══╡·╨ ╔═≡═╗ ╨·╞══╩
    ·  ║   ║  ·    
╦══╡·╥ ╚═══╝ ╥·╞══╦
║····║       ║····║
║·┌┐·╠═╡ • ╞═╣·┌┐·║
║·└┘·║··· ···║·└┘·║
║····║·╥·╥·╥·║····║
║■╔╡·╨·║·║·║·╨·╞╗■║
║·║····║·║·║····║·║
║·║·╞══╝·╨·╚══╡·║·║
║·╨·············╨·║
║···╥ ╔═════╗ ╥···║
╚═══╣ ║╔═══╗║ ╠═══╝
    ║»║║   ║║«║    
╔════════╦════════╗
║········║········║
║·╞╡·╞═╡·╨·╞═╡·╞╡·║
║·················║
║■╞╡·╥·╞═╦═╡·╥·╞╡■║
║····║···║···║····║
╚══╗·╠═╡ ╨ ╞═╣·╔══╝
   ║·║       ║·║   
═══╝·╨ ╔═≡═╗ ╨·╚═══
    ·  ║   ║  ·    
═══╗·╥ ╚═══╝ ╥·╔═══
   ║·║       ║·║   
╔══╝·╨ ╞═╦═╡ ╨·╚══╗
║········║········║
║·╥·╞══╡·╨·╞══╡·╥·║
║■╨······ ······╨■║
║···┌─┐·┌─┐·┌─┐···║
║·╥·└─┘·└─┘·└─┘·╥·║
║·╨·············╨·║
║···╥ ╔═════╗ ╥···║
╚═══╣ ║╔═══╗║ ╠═══╝
    ║»║║   ║║«║    
