1 32x16 RGHOST=3.5 ROGHOST=0 COGHOST=1.5 RFRUIT=5.5 RTOP=3.5 RHERO=7.5 RMSG=15 CMSG=11 RMSG2=0 CMSG2=11 ABOUT="Inspired by 'Blinky', a CHIP-8 and SCHIP game"
╔══════════════╕╒══════════════╗
║··············││··············║
║·╔══╡·┌┐·╞══╗·└┘·╔══╡·┌┐·╞══╗·║
║·║·■··││····║····║····││··■·║·║
║·╨·╞══╛╘╦═╡·╚════╝·╞═╦╛╘══╡·╨·║
║········║············║········║
║·╔════╗·╨·╔═╡·╞╡·╞═╗·╨·╔════╗·║
╝·╨····║···║···  ···║···║····╨·╚
  ··╞╡·╚╡·╞╝·┌────┐·╚╡·╞╝·╞╡··  
╗·╥··········└─┐┌─┘··········╥·╔
║·╚══╗·┌───┐···││···┌───┐·╔══╝·║
║··■·║·└───╘═╡·└┘·╞═╛───┘·║·■··║
║·┌┐·║····················║·┌┐·║
║·└┘·╚════╡·┌┐·╞╡·┌┐·╞════╝·└┘·║
║···········││····││···········║
╚═══════════╛╘════╛╘═══════════╝
