15 19x13 RHERO=7.5,6.5,8.5,4.5,9.5,7.5,7.5,7.5,9.5,7.5,8.5,10.5,6.5,6.5,9.5 CHERO=9.5,13.5,9.5,9.5,12.5,9.5,10.5,10.5,9.5,9.5,9.5,9.5,9.5,10.5,2.5 RGHOST=2.5,1.5,4.5,8.5,6.5,5.5,3.5,3.5,7.5,9.5,3.5,4.5,9.5,6.5,6.5 CGHOST=9.5,11.5,9.5,9.5,9.5,9.5,9.5,9.5,9.5,10.0,9.5,9.5,9.5,8.5,9.5 ROGHOST=0.0,0.0,0.0,6.0,3.0,0.0,0.0,0.0,0.0,0.0,0.0,0.0,6.0,0.0,0.0 COGHOST=5.0,0.0,4.0,3.0,3.0,6.0,5.0,5.0,7.0,2.5,5.0,6.0,2.0,0.0,3.0 RTOP=2.5,1.5,4.5,2.5,3.5,5.5,3.5,3.5,7.5,9.5,3.5,4.5,3.5,6.5,6.5 RFRUIT=7.5,6.5,8.5,4.5,9.5,7.5,7.5,7.5,9.5,7.5,8.5,10.5,6.5,6.5,9.5 CFRUIT=9.5,13.5,9.5,9.5,12.5,9.5,10.5,10.5,9.5,9.5,9.5,9.5,9.5,10.5,2.5 WALL_COLORS="\x00\x0A\x07" MORTAR_COLORS="\x01\x02\x04" DOT_COLORS="\x07\x0F\x0F" RMSG=12 CMSG=4 RMSG2=0 CMSG2=4 READY="  READY! " GAMEOVER=" GAME OVER " PLAYER1=" PLAYER ONE" PLAYER2=" PLAYER TWO" ABOUT="Inspired by Scott Harber's 'Big Yellow Head'"
╔═════════════════╗
║■···············■║
║·┌┐·┌┐·╔≡╗·┌┐·┌┐·║
║·└┘·└┘·╚═╝·└┘·└┘·║
║·················║
║·╞═══╗·┌─┐·╔═══╡·║
║·····╨·└─┘·╨·····║
║·╞═╡·········╞═╡·║
║·····╥·╞╦╡·╥·····║
║·╞═╡·╨··╨··╨·╞═╡·║
║■···············■║
╚═════════════════╝
                   
╔═════════════════╗
║■···············■║
║·╔═════════════╗·║
║·║·············║·║
║·║·╔═╦═══╦═══╗·║·║
║·║·║·╨···╨···║·║·║
║·║·║···╥···╥·║·║·║
║·║·║·╞═╩═══╩═╝·║·║
║·║·║···········║·║
║·╨·╚═══════════╝·║
║■···············■║
╚═════════════════╝
                   
╔═════════════════╗
║■···············■║
║·╥·╥·╥·╔≡╗·╥·╥·╥·║
║·║·║·║·║ ║·║·║·║·║
║·╨·║·║·║ ║·║·║·╨·║
║···╨·║·║ ║·║·╨···║
║·╥···╨·║ ║·╨···╥·║
║·║·╥···╚═╝···╥·║·║
║·║·║·╥·····╥·║·║·║
║·╨·╨·╨·╞═╡·╨·╨·╨·║
║■···············■║
╚═════════════════╝
                   
╔═════════════════╗
║■···············■║
║·┌──┐·╞╗·╔╡·┌──┐·║
║·└──┘··╚═╝··└──┘·║
║·················║
║·╞═══╡·╞╦╡·╞═══╡·║
║········║········║
║·╞════╗·║·╔════╡·║
║······║·║·║······║
║·╞══╡·╨·╨·╨·╞══╡·║
║■···············■║
╚═════════════════╝
                   
╔═════════════════╗
║■···············■║
║·╞══╗·╞══╕┐·┌┐·╥·║
║····║····││·││·║·║
║·╔╡·╚══╗·└┘·││·║·║
║·║·····║····││·║·║
║·║·┌─┐·╚══╗·└┘·║·║
║·║·│ │····║····╨·║
║·║·│ │·┌┐·╚══╗···║
║·╨·└─┘·└┘····╚═╡·║
║■·········┌┐····■║
╚══════════╛╘═════╝
                   
╔═════════════════╗
║■···············■║
║·╞══╗·┌───┐·╔══╡·║
║····╨·└───┘·╨····║
║·╔╡···········╞╗·║
║·║··╥·╔═≡═╗·╥··║·║
║·║··╨·╚═══╝·╨··║·║
║·╚╡···········╞╝·║
║····╥·┌───┐·╥····║
║·╞══╝·└───┘·╚══╡·║
║■···············■║
╚═════════════════╝
                   
╔═════════════════╗
║■···············■║
║·╔═══╡·╥·┌─┐·╞═╗·║
║·║·····║·│ │···║·║
║·╚╦═╦╡·╨·└─┘·╞╦╝·║
║··╨·╨·········╨··║
║·······╔═══╗·····║
║·╥·╥·╥·║···║·╥·╥·║
║·║·║·║·╨·╥·╨·║·║·║
║·╨·╚═╝···║···╚═╝·║
║■········║······■║
╚═════════╩═══════╝
                   
╔═════════════════╗
║■···············■║
║·╔═══╡·╥·┌─┐·╞═╗·║
║·║·····║·│ │···║·║
║·╚╦═╦╡·╨·└─┘·╞╦╝·║
║··╨·╨·········╨··║
║·······╔═══╗·····║
║·╥·╥·╥·║···║·╥·╥·║
║·║·║·║·╨·╥·╨·║·║·║
║·╨·╚═╝···║···╚═╝·║
║■········║······■║
╚═════════╩═══════╝
                   
╔═════════════════╗
║■···············■║
║·╥·╥·╥·╥·╥·╥·╥·╥·║
║·║·║·║·║·║·║·║·║·║
║·╨·╨·╨·╨·╨·╨·╨·╨·║
║·················║
║··╥·╥·╥·╥·╥·╥·╥··║
║··║·║·║·║·║·║·║··║
║··╨·╨·╨·╨·╨·╨·╨··║
║·················║
║■╞══╡·╞═╦═╡·╞══╡■║
║········║········║
╚════════╩════════╝
╔═════════════════╗
║■···············■║
║·╞═╗·┌──────┐·╔╡·║
║···║·└─┐  ┌─┘·║··║
║·╥·║···│  │···║··║
║·║·╚═╗·│  │·╔═╝··║
║·║···║·└──┘·║····║
║·╙─┐·║······║·┌┐·║
║·│ │·╚═╦≡≡╦═╝·││·║
║·│ │···║  ║···││·║
║■└─╘═╡·╚══╝·╞═╛┘■║
║·················║
╚═════════════════╝
╔═════════════════╗
║■···············■║
║·╞════╡·╞═══╗·┌┐·║
║············║·││·║
║·┌──┐·╞═╦═╗·║·││·║
║·│  │···╨·║·║·││·║
║·│  │·╥···║·║·││·║
║·└──┘·╚═══╝·╨·└┘·║
║·················║
║·╞══╗·╞═╦═╡·╔══╡·║
║■···╨···╨···╨···■║
║·┌┐···╥···╥···┌┐·║
╚═╛╘═══╩═══╩═══╛╘═╝
╔═════════════════╗
║■···············■║
║·┌──┐·╥···╥·┌──┐·║
║·└──┘·╚═══╝·└──┘·║
║·················║
║·┌──┐·╔═══╗·┌──┐·║
║·└──┘·╨···╨·└──┘·║
║········•········║
║·╞══╗·╥···╥·╔══╡·║
║····║·╚═══╝·║····║
║■╞╡·║·······║·╞╡■║
║····║·╔═══╗·║····║
╚════╩═╝   ╚═╩════╝
╔═════════════════╗
║■···············■║
║·╞═══╡·╥·╥·╞═══╡·║
║·······║·║·······║
║·╞═════╝·╚═════╡·║
║·················║
║·╞═════╡·╞═════╡·║
║·················║
║·╞═════╗·╔═════╡·║
║·······║·║·······║
║■╞═══╡·╨·╨·╞═══╡■║
║·················║
╚═════════════════╝
╔═════════════════╗
║■···············■║
║·╞═════════════╡·║
║·················║
║·╞════╡·╥·╞════╡·║
║········║········║
║·╞════╡·║·╞════╡·║
║········║········║
║·╞════╡·╨·╞════╡·║
║·················║
║■╞═════════════╡■║
║·················║
╚═════════════════╝
╔═════════════════╗
║■···············■║
║·╔═════════════╗·║
║·║·············║·║
║·║·┌┐·╥·╥·╥·┌┐·║·║
║·║·││·║·║·║·││·║·║
║·║·││·║·║·║·││·║·║
║·║·││·║·║·║·││·║·║
║·╨·└┘·╨·╨·╨·└┘·║·║
║···············║·║
║■╞═════════════╝■║
║·················║
╚═════════════════╝
