1 28x31 RGHOST=18.5 RFRUIT=20.5 RHERO=7.5 RMSG=20 RMSG2=14 ABOUT="Inspired by Wonka.com's 'Gobstopper Gobbler'"
┌─╒═══════╕╒════╕╒═══════╕─┐
│ l·······││····││·······l │
│ l·┌┐·┌┐·││·┌┐·││·┌┐·┌┐·l │
╓─┘·││·││·└┘·││·└┘·││·││·└─╖
║■··││·││····││····││·││··■║
║·┌─┘│·││·┌──┘└──┐·││·│└─┐·║
║·└──┘·└┘·└──────┘·└┘·└──┘·║
║············  ············║
║·┌──┐·┌───┐·┌┐·┌───┐·┌──┐·║
║·│  │·│   │·││·│   │·│  │·║
║·└──┘·└───┘·││·└───┘·└──┘·║
║············││············║
║·┌─────┐ ┌──┘└──┐ ┌─────┐·║
║·└─────┘ └──────┘ └─────┘·║
║······              ······║
╚════╗·┌┐ ╔══≡≡══╗ ┌┐·╔════╝
═════╝·││ ║      ║ ││·╚═════
   ····││ ║      ║ ││····   
═════╗·││ ║      ║ ││·╔═════
╔════╝·└┘ ╚══════╝ └┘·╚════╗
║······              ······║
║·┌┐·┌──┐ ┌──────┐ ┌──┐·┌┐·║
║·││·└─┐│ └──────┘ │┌─┘·││·║
║·││···││··········││···││·║
║·│└─┐·││·┌┐·┌┐·┌┐·││·┌─┘│·║
║·└─┐│·└┘·││·││·││·└┘·│┌─┘·║
║■··││····││·││·││····││··■║
╙─┐·││·┌──┘│·││·│└──┐·││·┌─╜
│ l·└┘·└───┘·││·└───┘·└┘·l │
│ l··········││··········l │
└─╘══════════╛╘══════════╛─┘
