1 39x21 RHERO=16.5 RFRUIT=13.5 RGHOST=11.5 RTOP=8.5 ROGHOST=2 COGHOST=2.5 RMSG=20 CMSG=14 RMSG2=0 CMSG2=14 READY="   READY!  " PLAYER1=" PLAYER ONE" PLAYER2=" PLAYER TWO" GAMEOVER=" GAME OVER " MORTAR_COLORS="\x05" DOT_COLORS="\x0A" ABOUT="Inspired by 'Guppy!' for the EXL100"
╔═════════════════════════════════════╗
║■···································■║
║·┌─────────┐·┌┐·┌───┐·┌┐·┌─────────┐·║
║·└─────────┘·││·└───┘·││·└─────────┘·║
║·············││·······││·············║
╚╗·╔══╗·╔═══╗·│└──┐·┌──┘│·╔═══╗·╔══╗·╔╝
 ║·║  ║·║   ║·└───┘·└───┘·║   ║·║  ║·║ 
 ║·║  ║·║   ║·············║   ║·║  ║·║ 
 ║·║  ║·║   ║·╔════≡════╗·║   ║·║  ║·║ 
═╝·╚══╝·╚═══╝·║         ║·╚═══╝·╚══╝·╚═
 ·············║         ║············· 
═╗·╔══╗·╔═══╗·║         ║·╔═══╗·╔══╗·╔═
 ║·║  ║·║   ║·╚═════════╝·║   ║·║  ║·║ 
 ║·║  ║·║   ║·············║   ║·║  ║·║ 
 ║·║  ║·║   ║·┌┐·┌───┐·┌┐·║   ║·║  ║·║ 
╔╝·╚══╝·╚═══╝·││·└───┘·││·╚═══╝·╚══╝·╚╗
║·············││·······││·············║
║·┌─────────┐·│└──┐·┌──┘│·┌─────────┐·║
║·└─────────┘·└───┘·└───┘·└─────────┘·║
║■···································■║
╚═════════════════════════════════════╝
