6 31x23 RHERO=14.5,17.5,11.5,13.5,7.5,18.5 RFRUIT=14.5,13.5,11.5,13.5,7.5,18.5 RGHOST=12.5,11.5,1.5,21.5,12.5,2.5 RTOP=9.5,8.5,4.5,19.5,15.5,4.5 COGHOST=1,1,1,2,0,2 ROGHOST=1,1,0,2,0,0 RMSG=15,13,12,19,22,3 CMSG=13 RMSG2=9,8,4,14,10,0 CMSG2=13 READY="READY" PLAYER1="P ONE" PLAYER2="P TWO" GAMEOVER="GONE." ABOUT="Inspired by James Pharaoh and Tim Fisken's 'Hatman'"
  ╔═══════╦════╦════╦═══════╗  
  ║■······╨····║····╨······■║  
  ║·╞═══╡···╞╗·╨·╔╡···╞═══╡·║  
  ║·······╥··║···║··╥·······║  
══╩══╡·╞╗·╚╡·╚═══╝·╞╝·╔╡·╞══╩══
   ·····║·············║·····   
══╗·╔═╡·╠╡·╞╗·╞╦╡·╔╡·╞╣·╞═╗·╔══
  ║·╨···╨···║··║··║···╨···╨·║  
  ║··■╥···╥·╚╡·╨·╞╝·╥···╥■··║  
  ║·╞═╩╡·╞╣·       ·╠╡·╞╩═╡·║  
  ║·······╚╡ ╔═≡═╗ ╞╝·······║  
  ║·╥·╞═╗··· ║   ║ ···╔═╡·╥·║  
  ║·║···╚╡·╥ ║   ║ ╥·╞╝···║·║  
  ║·║·╥····║ ╚═══╝ ║····╥·║·║  
  ║·╨·╚╡·╞═╝       ╚═╡·╞╝·╨·║  
  ║··········╔═══╗··········║  
══╝·╞═╗·╞╡·╞╦╝···╚╦╡·╞╡·╔═╡·╚══
   ···║··■··║··╥··║··■··║···   
══╗·╥·╚═══╡·╨·╞╬╡·╨·╞═══╝·╥·╔══
  ║·║··········║··········║·║  
  ║·╚════╡·╞═╡·║·╞═╡·╞════╝·║  
  ║············║············║  
  ╚════════════╩════════════╝  
  ╔═══════╦═════════╦═══════╗  
  ║·······║·········║·······║  
  ║■╞═══╡·╨·╞═════╡·╨·╞═══╡■║  
  ║·························║  
  ╚═══╗·╥·╔══╗·╥·╔══╗·╥·╔═══╝  
      ║·║·╚══╝·║·╚══╝·║·║      
══════╝·║······║······║·╚══════
       ·╚═╡ ╞══╩══╡ ╞═╝·       
══════╗·               ·╔══════
      ║·╔═╡ ╔═╦≡╦═╗ ╞═╗·║      
      ║·║   ║ ╨ ╨ ║   ║·║      
      ║·║ ╥ ║     ║ ╥ ║·║      
══════╝·╨ ║ ╚═════╝ ║ ╨·╚══════
       ·  ║         ║  ·       
══════╗·╞═╩══╡ ╥ ╞══╩═╡·╔══════
      ║······  ║  ······║      
  ╔═══╝·╞══╡·╞═╩═╡·╞══╡·╚═══╗  
  ║············ ············║  
  ║·╔══╗·╔═══╡·╥·╞═══╗·╔══╗·║  
  ║·║  ║·║·····║·····║·║  ║·║  
  ║■╚══╝·╨·╞═══╩═══╡·╨·╚══╝■║  
  ║·························║  
  ╚═════════════════════════╝  
╔═══════════╦═════╦═══════════╗
║···········║     ║···········║
║·╔╡·╞╗·╞═╗·╚═╗ ╔═╝·╔═╡·╔╡·╞╗·║
║·╨···║··■╨·  ╨ ╨  ·╨■··║···╨·║
║···╥·║·╥···╥     ╥···╥·║·╥···║
╝·╥·║·╨·╚╗·╔╩══╦══╩╗·╔╝·╨·║·╥·╚
 ·║·╨····╨·╨···╨···╨·╨····╨·║· 
╗·║···╞╗·····╥···╥·····╔╡···║·╔
║·║·╥··╠═══╦═╩╡·╞╩═╦═══╣··╥·║·║
║·║·╚╡·║···╨···■···╨···║·╞╝·║·║
║·╨····╨·╥···╞═══╡···╥·╨····╨·║
║···╔╗···╠═╡··· ···╞═╣···╔╗···║
╠═╡·╚╩═╗·╨···╞═══╡···╨·╔═╩╝·╞═╣
║······║···╥·······╥···║······║
║·╞╗·╥·╚╡·╞╩══╡·╞══╩╡·╞╝·╥·╔╡·║
║··║·║···················║·║··║
╠╡·║·╨·╞════╡·╞╦╡·╞════╡·╨·║·╞╣
╝·■║···········║···········║■·╚
 ·╞╩═╡·╞══╦╡·╥·║·╥·╞╦══╡·╞═╩╡· 
╗·········║··║·║·║··║·········╔
║·╞═════╡·╨·╞╝·║·╚╡·╨·╞═════╡·║
║··············║··············║
╚══════════════╩══════════════╝
╔═══════════╦═════╦═══════════╗
║···········╨··■··╨···········║
║·╥·╞══╦╗·╥···╥·╥···╥·╔╦══╡·╥·║
║·║■···╚╝·║·╥·╨·╨·╥·║·╚╝···■║·║
║·╚══╡····║·║·····║·║····╞══╝·║
║······╥·╔╝·║·╞╦╡·║·╚╗·╥······║
║·╔══╡·║·║··║··║··║··║·║·╞══╗·║
╝·╨····║·║·╔╩╡·║·╞╩╗·║·║····╨·╚
 ···╔╡·║·║·║···║···║·║·║·╞╗··· 
════╣··║·╨·║·╞═╩═╡·║·╨·║··╠════
 ···║·╞╣···║·······║···╠╡·║··· 
╗·╥·║··║·╞═╣·╥·╥·╥·╠═╡·║··║·╥·╔
║·║·╚╡·║···╨·║·╨·║·╨···║·╞╝·║·║
║·║····║·╥···║· ·║···╥·║····║·║
║·╚══╡·╨·╚═╗·╚═══╝·╔═╝·╨·╞══╝·║
║··········║·······║··········║
╠═╡·╞════╗·╚══╡·╞══╝·╔════╡·╞═╣
║········║···········║········║
║·╞═╡·╞╗·║·╞═══════╡·║·╔╡·╞═╡·║
║··■···║·║·         ·║·║···■··║
║·╞══╡·║·╨·╔═══≡═══╗·╨·║·╞══╡·║
║······║···║       ║···║······║
╚══════╩═══╩═══════╩═══╩══════╝
╔═════════╦═════════╦═════════╗
║·········║·········║·········║
║·╔╡·╞╗·╥·║·╥·╔═╗·╥·║·╥·╔╡·╞╗·║
║·║···║·╨·╨·║·╚═╝·║·╨·╨·║···║·║
║·║·╥·║·····║·····║·····║·╥·║·║
╝·╨·║·╚╡·╞╗·╚═╗·╔═╝·╔╡·╞╝·║·╨·╚
 ···║·····╨···╨·╨···╨·····║··· 
╗·╔═╩═══╗···╥·· ··╥···╔═══╩═╗·╔
║·╨·····╚╡·╞╝·╔═╗·╚╡·╞╝·····╨·║
║···╥·╥·······║ ║·······╥·╥···║
╠═══╣·╠═══════╣ ╠═══════╣·╠═══╣
║···╨·╨·······║ ║·······╨·╨···║
║·╥·····╥·╥·╥·║ ║·╥·╥·╥·····╥·║
║·╚╡·╔══╝·║·║·║ ║·║·║·╚══╗·╞╝·║
║····║····║·║·╨ ╨·║·║····║····║
║·╞══╝·╥·╞╣·╨·   ·╨·╠╡·╥·╚══╡·║
║······║··║···╞═╡···║··║······║
╠════╡·╚╗·║·╥·····╥·║·╔╝·╞════╣
║·······║·║·╠═╡·╞═╣·║·║·······║
╝·╔═══╗·╨·║·║·····║·║·╨·╔═══╗·╚
 ·╨···╨···╨·╨·╞═╡·╨·╨···╨···╨· 
╗···╥···╥·············╥···╥···╔
╚═══╩═══╩═════════════╩═══╩═══╝
║ ╠═══╗   ╔═════════╗   ╔═══╣ ║
║·╨···║ ╔═╣         ╠═╗ ║···╨·║
║···╥·╚═╝ ╚═══╡ ╞═══╝ ╚═╝·╥···║
║·╞═╝·····           ·····╚═╡·║
║·····╔═╗·╔═╡ ╞═╡ ╞═╗·╔═╗·····║
╚══╗·╔╝ ║·║·········║·║ ╚╗·╔══╝
   ║·║  ║·║·╔═════╗·║·║  ║·║   
 ╔═╝·╚══╣·╨·╚═════╝·╨·╠══╝·╚═╗ 
 ║······║·············║······║ 
 ║·╔╡·╥·╚═╦═══╗·╔═══╦═╝·╥·╞╗·║ 
 ║·║··║···║   ║·║   ║···║··║·║ 
═╝·║·╞╩═╡·║   ║·║   ║·╞═╩╡·║·╚═
 ··║······║   ║·║   ║······║·· 
═╗·╠═══╗·╞╬═══╝·╚═══╬╡·╔═══╣·╔═
 ║·║···║··║·········║··║···║·║ 
 ║·╨·╥·╚╡···╥·╞═╡·╥···╞╝·╥·╨·║ 
 ║···║····║·║·····║·║····║···║ 
 ╚═══╩═╦══╝·╚═╡·╞═╝·╚══╦═╩═══╝ 
       ║ ······ ······ ║       
══╦═══╦╩═·╔═══╦═╦═══╗·═╩╦═══╦══
 ·╨···╨···╨···╚═╝···╨···╨···╨· 
╗···╥···╥···╥·····╥···╥···╥···╔
║ ╔═╩═══╩═══╩═════╩═══╩═══╩═╗ ║
