7 29x17 FLIP_TO=3 READY="READY" GAMEOVER="GONE." PLAYER1="P ONE" PLAYER2="P TWO" WALL_COLORS="\x09\x04\x03\x02\x09\x04\x09" MORTAR_COLORS="\x07\x03\x07\x0E\x03\x03\x07" DOT_COLORS="\x07\x0E\x0E\x0F\x0F\x0E\x07" RGHOST=7.5 ROGHOST=2 COGHOST=1 RFRUIT=9.5 RTOP=6.5 RHERO=13.5 RMSG=9 CMSG=12 RMSG2=5 CMSG2=12 ABOUT="Inspired by Bally Midway's Jr. Pac-Man (maze very reduced)"
╔═══════╦═════╦═════╦═══════╗
║·······║·····║·····║·······║
║■╥·╞═╗·╨·╞═╗·╨·╔═╡·╨·╔═╡·╥■║
║·║···║···  ║···║  ···║···║·║
║·╨·╥·╨·╞═╡ ╨ • ╨ ╞═╡·╨·╥·╨·║
║···║·····         ·····║···║
║·╥·║·╞═╡·╥ ╔═≡═╗ ╥·╞═╡·║·╥·║
║·║·║··■··║ ║   ║ ║··■··║·║·║
║·╨·╨·╞═╡·╨ ╚═══╝ ╨·╞═╡·╨·╨·║
║· ·······         ······· ·║
║·╞═╗·╥ ╞═╡ ╞═╦═╡ ╞═╡ ╥·╔═╡·║
║···║·║  ·····║·····  ║·║···║
║·╥·╨·╚═╡·╥·╥·╨·╥·╥·╞═╝·╨·╥·║
║·║·······║·║· ·║·║·······║·║
║■╨ ╞═╡·╥·╨·╨·╥·╨·╨·╥·╞═╡ ╨■║
║·······║·····║·····║·······║
╚═══════╩═════╩═════╩═══════╝
  ╔═══════════════════════╗  
  ║·······················║  
╔═╝·╞═╗·╥·╞═╡·╥·╞═╡·╥·╔═╡·╚═╗
║·····║·║·····║·····║·║·····║
║■╞═╗·║·╚═╡·╞═╩═╡·╞═╝·║·╔═╡■║
║···║·║·····     ·····║·║···║
║·╥·╨·║·╞═╗·╔═≡═╗·╔═╡·║·╨·╥·║
║·║···║■··║·║   ║·║··■║···║·║
║·╚═╗·╨·╥·╨·╚═══╝·╨·╥·╨·╔═╝·║
║···║···║···     ···║···║···║
║·╥·╚═╗·╚═══╡ ╥ ╞═══╝·╔═╝·╥·║
║·║···║·····  ║  ·····║···║·║
║·╨·╥·╨·┌─┐·╞═╩═╡·┌─┐·╨·╥·╨·║
║···║· ·│ │··· ···│ │· ·║···║
║■╞═╝·╥·└─┘·╞═══╡·└─┘·╥·╚═╡■║
║·····║···············║·····║
╚═════╩═══════════════╩═════╝
╔═══╦═══╦═══════════╦═══╦═══╗
║···║···║···········║···║···║
║·╥·╨·•·╨·╥ ╞═╦═╡ ╥·╨·•·╨·╥·║
║■║·······║   ║   ║·······║■║
║·╚═╡·╥·╥·╚═╡ ╨ ╞═╝·╥·╥·╞═╝·║
║·····║■║·         ·║■║·····║
║·•·╞═╣·╚═╡ ╔═≡═╗ ╞═╝·╠═╡·•·║
║·····║···  ║   ║  ···║·····║
║·╞═╗·╚═╡·╥ ╚═══╝ ╥·╞═╝·╔═╡·║
║···║·····║       ║·····║···║
╠═╡·╠═╡·╞═╣ ╞═╦═╡ ╠═╡·╞═╣·╞═╣
║···║·····║   ║   ║·····║···║
║·╥·╨·╞═╗·╚═╡ ╨ ╞═╝·╔═╡·╨·╥·║
║·║·····║····· ·····║·····║·║
║■╚═╡·•·╨·╞═╡·•·╞═╡·╨·•·╞═╝■║
║···························║
╚═══════════════════════════╝
  ╔═════╦═══════════╦═════╗  
  ║·····║···········║·····║  
╔═╝·╥ •·╨·•·╥ ╥ ╥·•·╨·• ╥·╚═╗
║■··║·······║ ║ ║·······║··■║
║·╞═╝·╞═══╦═╝ ╨ ╚═╦═══╡·╚═╡·║
║·········║       ║·········║
╠═══╗·╥·╥·╨ ╔═≡═╗ ╨·╥·╥·╔═══╣
║···║·║·║·  ║   ║  ·║·║·║···║
║·╥·╨·║·╨·╥ ╚═══╝ ╥·╨·║·╨·╥·║
║·║···║···║       ║···║···║·║
║·╚═╗·╚═══╩═╗ ╥ ╔═╩═══╝·╔═╝·║
║···║·······║ ║ ║·······║···║
╠═╡·╨·╞═══╗·╨ ╨ ╨·╔═══╡·╨·╞═╣
║····· ···║··· ···║··· ·····║
║·•·•·╥·•·╨ •·╥·• ╨·•·╥·•·•·║
║■····║·······║·······║····■║
╚═════╩═══════╩═══════╩═════╝
╔═════╦═══╦═══════╦═══╦═════╗
║·····║···║·······║···║·····║
║·╞═╡·╨·╥·╨·╥·•·╥·╨·╥·╨·╞═╡·║
║··■····║···║···║···║····■··║
║·╥·╥·╞═╝·╥ ╚═══╝ ╥·╚═╡·╥·╥·║
║·║·║· ···║       ║··· ·║·║·║
║·╨·╨·╥·╥·╨ ╔═≡═╗ ╨·╥·╥·╨·╨·║
║··· ·║■║·  ║   ║  ·║■║· ···║
╠═╡·╥·╨·╨·╥ ╚═══╝ ╥·╨·╨·╥·╞═╣
║···║·····║       ║·····║···║
║·╥·╨ ╞═╡·╚═╡ ╥ ╞═╝·╞═╡ ╨·╥·║
║·║·······    ║    ·······║·║
║·╨·╔╡·╥·╞╡ ╞═╩═╡ ╞╡·╥·╞╗·╨·║
║··■║··║····     ····║··║■··║
║·•·╨·╞╩╡·╥·╞═══╡·╥·╞╩╡·╨·•·║
║·········║·······║·········║
╚═════════╩═══════╩═════════╝
╔═══╦═════╦═══════╦═════╦═══╗
║···║·····║·······║·····║···║
║·╥·╨·╥·╥·╨·╥ ╥ ╥·╨·╥·╥·╨·╥·║
║·║···║·║···║ ║ ║···║·║···║·║
║·╚═╦═╝·╚═╦═╝ ╨ ╚═╦═╝·╚═╦═╝·║
║···║··■··║       ║··■··║···║
╠═╡·╨·╔═╡·╨ ╔═≡═╗ ╨·╞═╗·╨·╞═╣
║·····║···  ║   ║  ···║·····║
║·╥·╞═╣·╞═╗ ╚═══╝ ╔═╡·╠═╡·╥·║
║·║···║···║       ║···║···║·║
║·╨·╥·╚═╡·╠═╡ ╥ ╞═╣·╞═╝·╥·╨·║
║···║■····║   ║   ║····■║···║
║·╞═╝·╥·╞═╝ ╔═╩═╗ ╚═╡·╥·╚═╡·║
║·····║·····║   ║·····║·····║
║·╞═╡·║·╞═╡·╨ ╥ ╨·╞═╡·║·╞═╡·║
║·····║·······║·······║·····║
╚═════╩═══════╩═══════╩═════╝
╔═══════╦═══╦═══╦═══╦═══════╗
║·······║···║···║···║·······║
║·╔═══╗·║·╥·╨·╥·╨·╥·║·╔═══╗·║
║·║···║·║·║···║···║·║·║···║·║
║·║·•·╨·║·╠═╡ ╨ ╞═╣·║·╨·•·║·║
║·║··■··║·║       ║·║··■··║·║
║·╚═╡·•·╨·╨ ╔═≡═╗ ╨·╨·•·╞═╝·║
║·········  ║   ║  ·········║
╠═════╡·╞═╡ ╚═══╝ ╞═╡·╞═════╣
║·········         ·········║
║·╔═╡·•·╥·╔═╡ ╥ ╞═╗·╥·•·╞═╗·║
║·║··■··║·║   ║   ║·║··■··║·║
║·║·•·╥·║·║ ╞═╩═╡ ║·║·╥·•·║·║
║·║···║·║·║··· ···║·║·║···║·║
║·╚═══╝·║·╚═╡·╥·╞═╝·║·╚═══╝·║
║·······║·····║·····║·······║
╚═══════╩═════╩═════╩═══════╝
