1 39x23 READY="   READY!  " GAMEOVER=" GAME OVER " PLAYER1="PLAYER  ONE" PLAYER2="PLAYER  TWO" RGHOST=11.5 ROGHOST=2 COGHOST=3 RFRUIT=13.5 RTOP=10.5 RHERO=17.5 RMSG=13 CMSG=14 RMSG2=9 CMSG2=14 ABOUT="Inspired by Steven Hanov's 'PacMan Lives' game"
╔══════════════════╦══════════════════╗
║··················║··················║
║·┌────┐·┌───────┐·║·┌───────┐·┌────┐·║
║·│    │·│       │·║·│       │·│    │·║
║■└────┘·└───────┘·╨·└───────┘·└────┘■║
║·····································║
║·╞════╡·┌─┐·╞═════╦═════╡·┌─┐·╞════╡·║
║········│ │·······║·······│ │········║
╚══════╗·│ ╞═════╡ ╨ ╞═════╡ │·╔══════╝
       ║·│ │               │ │·║       
═══════╝·└─┘ ╔═════≡═════╗ └─┘·╚═══════
 ··········  ║           ║  ·········· 
═══════╗·┌─┐ ╚═══════════╝ ┌─┐·╔═══════
       ║·│ │               │ │·║       
╔══════╝·└─┘ ╞═════╦═════╡ └─┘·╚══════╗
║··················║··················║
║·╞════╗·╞═══════╡·╨·╞═══════╡·╔════╡·║
║■·····║·······················║·····■║
╠════╡·╨·┌─┐·╞═════╦═════╡·┌─┐·╨·╞════╣
║········│ │·······║·······│ │········║
║·╞══════╛─╘═════╡·╨·╞═════╛─╘══════╡·║
║·····································║
╚═════════════════════════════════════╝
