9 21x16 READY="  READY! " GAMEOVER="GAME OVER" PLAYER1="PLAYER  1" PLAYER2="PLAYER  2" RGHOST=8.5 RFRUIT=10.5 RHERO=10.5 RMSG=5 CMSG=6 RMSG2=5 CMSG2=6 ABOUT="Inspired by Markellos J. Diorinos's 'MakMan/2', which bears some resemblance to Jerry J. Shekhel/Polygen Corp.'s 'Chomp'"
╔═════════╦═════════╗
║·········║·········║
║■╞═╡·╞╦╡·║·╞═╡·╞═╡■║
║······║··║·········║
╠═╡·╞╗·╨·╞╩╡·╞╡·╥·╥·║
║····║··········║·║·║
║·┌┐·║·╔══≡══╗·╞╝·╨·║
║·││·╨·║     ║······║
║·││···║     ║·┌──┐·║
║·└┘·╥·╚═════╝·└──┘·║
║····║···· ·········║
╠═╡·╞╝·╞══╦══╡·╥·•·╞╣
║·········║····║····║
║■╞═════╡·╨·╞══╩══╡■║
║···················║
╚═══════════════════╝
╔═════════╦═════════╗
║·········║·········║
║■╞═╗·╞═╡·║·╞═╡·╔═╡■║
║···║·····║·····║···║
║·╥·╚═══╡·╨·╞═══╝·╥·║
║·║···············║·║
║·╚══╡·╔══≡══╗·╞══╝·║
║······║     ║······║
║·┌┐·╥·║     ║·╥·┌┐·║
║·└┘·║·╚═════╝·║·└┘·║
║····║···· ····║····║
╠═╡·╞╝·╞═╗·╔═╡·╚╡·╞═╣
║········║·║········║
║■╞══╡·╥·╨·╨·╥·╞══╡■║
║······║·····║······║
╚══════╩═════╩══════╝
╔═══════════════════╗
║···················║
║■╔═╡·╔═══════╗·╞═╗■║
║·╨···║·······║···╨·║
║···╥·╨·╞═══╡·╨·╥···║
╠═╡·╨···········╨·╞═╣
║····╥·╔══≡══╗·╥····║
║·╞╡·║·║     ║·║·╞╡·║
║····║·║     ║·║····║
║·╔╡·╨·╚═════╝·╨·╞╗·║
║·╨······· ·······╨·║
║···╔╡·╞╗·╥·╔╡·╞╗···║
║·╥·║···║·║·║···║·╥·║
║■╨·╨·╥·╨·║·╨·╥·╨·╨■║
║·····║···║···║·····║
╚═════╩═══╩═══╩═════╝
╔═════╦═══╦═══╦═════╗
║·····║···║···║·····║
║■•·╥·╨·╥·╨·╥·╨·╥·•■║
║···║···║···║···║···║
╠╡·╞╩╡·╞╩╡·╞╩╡·╞╩╡·╞╣
║···················║
║·╔╡·•·╔══≡══╗·•·╞╗·║
║·╨····║     ║····╨·║
║···┌┐·║     ║·┌┐···║
║·•·└┘·╚═════╝·└┘·•·║
║········· ·········║
╠╡·╞╦╡·╞╦╡·╞╦╡·╞╦╡·╞╣
║···║···║···║···║···║
║■•·╨·╥·╨·╥·╨·╥·╨·•■║
║·····║···║···║·····║
╚═════╩═══╩═══╩═════╝
╔═══════════════════╗
║···················║
║■•·•·•·•·•·•·•·•·•■║
║···················║
║·•·•·•·•·•·•·•·•·•·║
║···················║
║·•·╞╡·╔══≡══╗·╞╡·•·║
║······║     ║······║
║·╥·┌┐·║     ║·┌┐·╥·║
║·╨·└┘·╚═════╝·└┘·╨·║
║········· ·········║
║·•·•·•·•·•·•·•·•·•·║
║···················║
║■•·•·•·•·•·•·•·•·•■║
║···················║
╚═══════════════════╝
╔═════════╦═════════╗
║·········║·········║
║■╞╡·╔══╡·╨·╞══╗·╞╡■║
║····║·········║····║
║·┌┐·╨·╞═════╡·╨·┌┐·║
║·││·············││·║
║·││·╥·╔══≡══╗·╥·││·║
║·└┘·║·║     ║·║·└┘·║
║····║·║     ║·║····║
║·╞╡·╨·╚═════╝·╨·┌┐·║
║········· ······││·║
╠══╡·╥·╞═════╡·╥·└┘·║
║····║·········║····║
║■╞══╩══╡·╥·╞══╩══╡■║
║·········║·········║
╚═════════╩═════════╝
╔═══╦═══════╦═══════╗
║···║·······║·······║
║■╥·║·╔═══╡·╨·╞╡·╞╡■║
║·║·╨·║·············║
║·╨···╨·╞══╡·╞═╡·╞╗·║
║···╥·············║·║
║·╞═╩╡·╔══≡══╗·┌┐·╨·║
║······║     ║·││···║
║·╔══╡·║     ║·└┘·╥·║
║·╨····╚═════╝····║·║
║···╞╗···· ····╥·╞╝·║
║·╥··╚╡·╥·╞╗·╞═╝····║
║·╙┐····║··║·····┌┐·║
║■└╘╡·╞═╩╡·╨·╞═╡·└┘■║
║···················║
╚═══════════════════╝
╔═════════╦═════════╗
║·········║·········║
║■╥·╞═╡·╥·╨·╥·╞═╡·╥■║
║·╨·····║···║·····╨·║
║···╞╡·╞╝·•·╚╡·┌┐···║
╠═╡············││·╞═╣
║···╞╡·╔══≡══╗·└┘···║
║·•····║     ║····╥·║
║···┌┐·║     ║·╞══╣·║
╠═╡·││·╚═════╝····╨·║
║···└┘···· ····╔╡···║
║·╥····╞╗·╞╗·╥·╨··╥·║
║·║·┌┐··║··║·║···┌╜·║
║■╨·└╘╡·╚╡·╨·╚═╡·└┘■║
║···················║
╚═══════════════════╝
╔═══════════════════╗
║···················║
║■╞╡·╞═╗·╞═╗·╥·╔╡·╥■║
║······║···║·║·║··║·║
║·╔══╡·╨·•·╨·╨·╨·╞╝·║
║·╨·················║
║···╞╗·╔══≡══╗·┌┐·•·║
║·╥··╨·║     ║·╓┘···║
║·╚╡···║     ║·╨··╥·║
║····╥·╚═════╝···┌╜·║
║·╞╡·╨···· ····•·└┘·║
║······╞╕┐·┌╒╡······║
║·┌┐·╥··└╖·╓┘··╥·┌┐·║
║■└┘·╙┐··╨·╨··┌╜·└┘■║
║····└╘╡·····╞╛┘····║
╚═══════════════════╝
