6 19x22~1 FLIP_TO=2 READY=" READY!" GAMEOVER="GOODBYE" PLAYER1="PLAYER1" PLAYER2="PLAYER2" WALL_COLORS="\x07\x03\x04\x09\x0D\x07" MORTAR_COLORS="\x0C\x0F\x0F\x07\x05\x0C" DOT_COLORS="\x0F\x0E\x0C\x0F\x0F\x0F" RGHOST=10.5 ROGHOST=1 COGHOST=1 RFRUIT=12.5 RTOP=9 RHERO=16.5 RMSG=12 CMSG=6 RMSG2=8 CMSG2=6 ABOUT="Inspired by Peter Siamidis's 'Ms. Chomp' for windows"
╔════╦═══════╦════╗
║····║·······║····║
║■╞╡·╨·╞═══╡·╨·╞╡■║
║·················║
╚╗·╥·┌─┐·╥·┌─┐·╥·╔╝
═╝·║·└─┘·║·└─┘·║·╚═
  ·║·····║·····║·  
═╗·╚═╡ ╞═╩═╡ ╞═╝·╔═
 ║·             ·║ 
 ║·╔═╡ ╔═≡═╗ ╞═╗·║ 
 ║·║   ║   ║   ║·║ 
═╝·╨ ╥ ╚═══╝ ╥ ╨·╚═
  ·  ║       ║  ·  
═╗·╞═╩═╡ ╥ ╞═╩═╡·╔═
 ║·····  ║  ·····║ 
╔╝·╞═╡·╞═╩═╡·╞═╡·╚╗
║········ ········║
║·┌┐·╔═╡·╥·╞═╗·┌┐·║
║·││·║···║···║·││·║
║■└┘·╨·╞═╩═╡·╨·└┘■║
║·················║
╚═════════════════╝
═════╦═══════╦═════
     ║·······║     
╦══╡ ╨·╞═╦═╡·╨ ╞══╦
║········║········║
║■╔══╡·╥·║·╥·╞══╗■║
║·║····║·╨·║····║·║
║·║·┌┐ ║···║ ┌┐·║·║
║·╨·└╖ ╚═══╝ ╓┘·╨·║
║····║       ║····║
╠══╡·║ ╔═≡═╗ ║·╞══╣
║····╨ ║   ║ ╨····║
║·╞╗·  ╚═══╝  ·╔╡·║
║··║·╥       ╥·║··║
╚╗·╨·╚╡ ┌─┐ ╞╝·╨·╔╝
 ║······│ │······║ 
═╝·╞═╦╡·└─┘·╞╦═╡·╚═
  ···║··· ···║···  
╦═·╥·╨·╞═╦═╡·╨·╥·═╦
║··║·····║·····║··║
║■╞╝·╞═╡·╨·╞═╡·╚╡■║
║·················║
╚═════════════════╝
╔══════╦═══╦══════╗
║······║···║······║
║■╔══╡·╨·╥·╨·╞══╗■║
║·║······║······║·║
║·╨·╥·┌┐·║·┌┐·╥·╨·║
║···║·└┘·╨·└┘·║···║
╩═╡·║·········║·╞═╩
 ···╚╡ ╞═══╡ ╞╝··· 
╗·╥             ╥·╔
║·╚╡ ╥ ╔═≡═╗ ╥ ╞╝·║
║·   ║ ║   ║ ║   ·║
║·╥ ╞╝ ╚═══╝ ╚╡ ╥·║
║·║             ║·║
║·╚╡ ╔═╡ ╥ ╞═╗ ╞╝·║
║····║···║···║····║
╠╡·╥·╨·╞═╩═╡·╨·╥·╞╣
║··║····· ·····║··║
║■╞╝·╔═╡·╥·╞═╗·╚╡■║
║····║···║···║····║
║·╞╡·║·╞═╩═╡·║·╞╡·║
║····║·······║····║
╚════╩═══════╩════╝
╔═════════════════╗
║·················║
║■╥·┌┐·╔═══╗·┌┐·╥■║
║·║·└┘·║···║·└┘·║·║
║·║····║·╥·║····║·║
║·╚╡·╥·╨·║·╨·╥·╞╝·║
║····║···║···║····║
╚╗·╞═╬═╡ ╨ ╞═╬═╡·╔╝
═╝···║       ║···╚═
   ╥·╨ ╔═≡═╗ ╨·╥   
═══╣·  ║   ║  ·╠═══
   ╨·╥ ╚═══╝ ╥·╨   
═╗···║       ║···╔═
 ║·╥·╚═╡ ╥ ╞═╝·╥·║ 
 ║·║···  ║  ···║·║ 
╔╝·╚═╡·╥ ╨ ╥·╞═╝·╚╗
║······║   ║······║
║·╔╡·╥·╚═══╝·╥·╞╗·║
║·║··║·······║··║·║
║■╨·╞╩═╡·╥·╞═╩╡·╨■║
║········║········║
╚════════╩════════╝
╔══════╦═══╦══════╗
║······║···║······║
║■╔══╡·╨·╥·╨·╞══╗■║
║·║······║······║·║
║·╨·╥·┌┐·║·┌┐·╥·╨·║
║···║·└┘·╨·└┘·║···║
╩═╡·║·········║·╞═╩
 ···╚╡ ╞═══╡ ╞╝··· 
╗·╥             ╥·╔
║·╚╡ ╥ ╔═≡═╗ ╥ ╞╝·║
║·   ║ ║   ║ ║   ·║
║·╥ ╞╝ ╚═══╝ ╚╡ ╥·║
║·║             ║·║
║·╚╡ ╔═╡ ╥ ╞═╗ ╞╝·║
║····║···║···║····║
╠╡·╥·╨·╞═╩═╡·╨·╥·╞╣
║··║····· ·····║··║
║■╞╝·╔═╡·╥·╞═╗·╚╡■║
║····║···║···║····║
║·╞╡·║·╞═╩═╡·║·╞╡·║
║····║·······║····║
╚════╩═══════╩════╝
╔═════════════════╗
║·················║
║■╥·┌┐·╔═══╗·┌┐·╥■║
║·║·└┘·║···║·└┘·║·║
║·║····║·╥·║····║·║
║·╚╡·╥·╨·║·╨·╥·╞╝·║
║····║···║···║····║
╚╗·╞═╬═╡ ╨ ╞═╬═╡·╔╝
═╝···║       ║···╚═
   ╥·╨ ╔═≡═╗ ╨·╥   
═══╣·  ║   ║  ·╠═══
   ╨·╥ ╚═══╝ ╥·╨   
═╗···║       ║···╔═
 ║·╥·╚═╡ ╥ ╞═╝·╥·║ 
 ║·║···  ║  ···║·║ 
╔╝·╚═╡·╥ ╨ ╥·╞═╝·╚╗
║······║   ║······║
║·╔╡·╥·╚═══╝·╥·╞╗·║
║·║··║·······║··║·║
║■╨·╞╩═╡·╥·╞═╩╡·╨■║
║········║········║
╚════════╩════════╝
