6 19x23~1 FLIP_TO=2 READY=" READY!" GAMEOVER="GOODBYE" PLAYER1=" P ONE " PLAYER2=" P TWO " WALL_COLORS="\x07\x03\x04\x09\x0D\x07" MORTAR_COLORS="\x0C\x0F\x0F\x07\x05\x0C" DOT_COLORS="\x0F\x0E\x0C\x0F\x0F\x0F" RGHOST=11 ROGHOST=2 COGHOST=1 RFRUIT=13.5 RTOP=7.5 RHERO=17.5 RMSG=13 CMSG=6 RMSG2=7 CMSG2=6 ABOUT="Inspired by Nukey Shay's 'Ms. Hack' Pesco hack"
╔════╦═══════╦════╗
║····║··· ···║····║
║■╞╡·╨·╞═══╡·╨·╞╡■║
║········ ········║
╩╡·╥·╞═╡·╥·╞═╡·╥·╞╩
  ·║·····║·····║·  
═╗·╚═╡ ╞═╩═╡ ╞═╝·╔═
 ║·             ·║ 
 ║·╔═╡ ╔═≡═╗ ╞═╗·║ 
 ║·║·· ║   ║ ··║·║ 
 ║·║·╥ ║   ║ ╥·║·║ 
 ║·║·║ ║   ║ ║·║·║ 
═╝·╨·║ ╚═══╝ ║·╨·╚═
  ···║       ║···  
═╗·╞═╩═╡ ╥ ╞═╩═╡·╔═
 ║·······║·······║ 
╔╝·╞═╡·╞═╩═╡·╞═╡·╚╗
║········ ········║
║·┌┐·╔═╡·╥·╞═╗·┌┐·║
║·││·║···║···║·││·║
║■└┘·╨·╞═╩═╡·╨·└┘■║
║········ ········║
╚═════════════════╝
═════╦═══════╦═════
     ║··· ···║     
╦══╡·╨·╞═╦═╡·╨·╞══╦
║········║········║
║■╔══╡·╥·╨·╥·╞══╗■║
║·║····║· ·║····║·║
║·╨·╞╗ ╚═══╝ ╔╡·╨·║
║····║       ║····║
╠══╡·║ ╔═≡═╗ ║·╞══╣
║····║ ║   ║ ║····║
║·╞╗·╨ ║   ║ ╨·╔╡·║
║··║·  ║   ║  ·║··║
╚╗·║·╥ ╚═══╝ ╥·║·╔╝
 ║·║·║       ║·║·║ 
 ║·╨·╚╡ ┌─┐ ╞╝·╨·║ 
 ║······│ │······║ 
═╝·╞═╦╡·└─┘·╞╦═╡·╚═
  ···║··· ···║···  
╦╡·╥·╨·╞═╦═╡·╨·╥·╞╦
║··║·····║·····║··║
║■╞╝·╞═╡·╨·╞═╡·╚╡■║
║········ ········║
╚═════════════════╝
╔══════╦═══╦══════╗
║······║· ·║······║
║■╔══╡·╨·╥·╨·╞══╗■║
║·║······║······║·║
║·╨·╥·╞╡·╨·╞╡·╥·╨·║
║···║···· ····║···║
╩═╡ ╚╡ ╞═══╡ ╞╝ ╞═╩
                   
╗·╥ ╞╗ ╔═≡═╗ ╔╡ ╥·╔
║·║  ║ ║   ║ ║  ║·║
║·╚╡ ║ ║   ║ ║ ╞╝·║
║··· ║ ║   ║ ║ ···║
║·╥·╞╝ ╚═══╝ ╚╡·╥·║
║·║··         ··║·║
║·╚╡·╔═╡·╥·╞═╗·╞╝·║
║····║···║···║····║
╠╡·╥·╨·╞═╩═╡·╨·╥·╞╣
║··║····· ·····║··║
║■╞╝·╔═╡·╥·╞═╗·╚╡■║
║····║···║···║····║
║·╞╡·║·╞═╩═╡·║·╞╡·║
║····║··· ···║····║
╚════╩═══════╩════╝
╔═════════════════╗
║········ ········║
║·╥·╞╡·╔═══╗·╞╡·╥·║
║·║····║· ·║····║·║
║■╠╡·╥·╨·╥·╨·╥·╞╣■║
║·║··║···║···║··║·║
║·╨·╞╬═╡ ╨ ╞═╬╡·╨·║
║····║       ║····║
╩╡ ╥·╨ ╔═≡═╗ ╨·╥ ╞╩
   ║·  ║   ║  ·║   
═══╣·╥ ║   ║ ╥·╠═══
   ║·║ ║   ║ ║·║   
═╗ ╨·║ ╚═══╝ ║·╨ ╔═
 ║···║       ║···║ 
 ║·╥·╚═╡ ╥ ╞═╝·╥·║ 
 ║·║·····║·····║·║ 
╔╝·╚═╡·╥·╨·╥·╞═╝·╚╗
║······║· ·║······║
║■╔╡·╥·╚═══╝·╥·╞╗■║
║·║··║··· ···║··║·║
║·╨·╞╩═╡·╥·╞═╩╡·╨·║
║········║········║
╚════════╩════════╝
╔══════╦═══╦══════╗
║······║· ·║······║
║■╔══╡·╨·╥·╨·╞══╗■║
║·║······║······║·║
║·╨·╥·╞╡·╨·╞╡·╥·╨·║
║···║···· ····║···║
╩═╡ ╚╡ ╞═══╡ ╞╝ ╞═╩
                   
╗·╥ ╞╗ ╔═≡═╗ ╔╡ ╥·╔
║·║  ║ ║   ║ ║  ║·║
║·╚╡ ║ ║   ║ ║ ╞╝·║
║··· ║ ║   ║ ║ ···║
║·╥·╞╝ ╚═══╝ ╚╡·╥·║
║·║··         ··║·║
║·╚╡·╔═╡·╥·╞═╗·╞╝·║
║····║···║···║····║
╠╡·╥·╨·╞═╩═╡·╨·╥·╞╣
║··║····· ·····║··║
║■╞╝·╔═╡·╥·╞═╗·╚╡■║
║····║···║···║····║
║·╞╡·║·╞═╩═╡·║·╞╡·║
║····║··· ···║····║
╚════╩═══════╩════╝
╔═════════════════╗
║········ ········║
║·╥·╞╡·╔═══╗·╞╡·╥·║
║·║····║· ·║····║·║
║■╠╡·╥·╨·╥·╨·╥·╞╣■║
║·║··║···║···║··║·║
║·╨·╞╬═╡ ╨ ╞═╬╡·╨·║
║····║       ║····║
╩╡ ╥·╨ ╔═≡═╗ ╨·╥ ╞╩
   ║·  ║   ║  ·║   
═══╣·╥ ║   ║ ╥·╠═══
   ║·║ ║   ║ ║·║   
═╗ ╨·║ ╚═══╝ ║·╨ ╔═
 ║···║       ║···║ 
 ║·╥·╚═╡ ╥ ╞═╝·╥·║ 
 ║·║·····║·····║·║ 
╔╝·╚═╡·╥·╨·╥·╞═╝·╚╗
║······║· ·║······║
║■╔╡·╥·╚═══╝·╥·╞╗■║
║·║··║··· ···║··║·║
║·╨·╞╩═╡·╥·╞═╩╡·╨·║
║········║········║
╚════════╩════════╝
