6 32x22~1 FLIP_TO=2 WALL_COLORS="\x07\x03\x04\x09\x0D\x07" MORTAR_COLORS="\x0C\x0F\x0F\x07\x05\x0C" DOT_COLORS="\x0F\x0E\x0C\x0F\x0F\x0F" RGHOST=10.5 ROGHOST=1 RFRUIT=12.5 RTOP=8.5 RHERO=16.5 RMSG=12 CMSG=11 RMSG2=8 CMSG2=11 ABOUT="Inspired by Atarisoft's ZX Spectrum Ms. Pac-Man conversion"
┌╒═══════╕╒══════════╕╒═══════╕┐
││·······││··········││·······││
││■╞═══╡·└┘·╞══════╡·└┘·╞═══╡■││
││····························││
└╘═╕┐·┌┐·┌───┐·┌┐·┌───┐·┌┐·┌╒═╛┘
   ││·││·└───┘·││·└───┘·││·││   
═══╛┘·││·······││·······││·└╘═══
     ·└╘══╡ ╞══╛╘══╡ ╞══╛┘·     
═══╕┐·                    ·┌╒═══
   ││·┌╒══╡ ╔══≡≡══╗ ╞══╕┐·││   
   ││·││    ║      ║    ││·││   
═══╛┘·└┘ ┌┐ ╚══════╝ ┌┐ └┘·└╘═══
     ·   ││          ││   ·     
═══╕┐·╞══╛╘══╡ ┌┐ ╞══╛╘══╡·┌╒═══
   ││·······   ││   ·······││   
┌╒═╛┘·╞═══╡·╞══╛╘══╡·╞═══╡·└╘═╕┐
││············    ············││
││·┌──┐·┌╒═══╡·┌┐·╞═══╕┐·┌──┐·││
││·│  │·││·····││·····││·│  │·││
││■└──┘·└┘·╞═══╛╘═══╡·└┘·└──┘■││
││····························││
└╘════════════════════════════╛┘
═════════╕╒══════════╕╒═════════
         ││··········││         
╕╒═════╡ └┘·╞══╕╒══╡·└┘ ╞═════╕╒
││■············││············■││
││·┌╒═════╡ ┌┐·││·┌┐ ╞═════╕┐·││
││·││·······││·└┘·││·······││·││
││·└┘·╞══╕┐ ││····││ ┌╒══╡·└┘·││
││·······││ └╘════╛┘ ││·······││
│╞═════╡·││          ││·╞═════╡│
││·······││ ╔══≡≡══╗ ││·······││
││·╞══╕┐·└┘ ║      ║ └┘·┌╒══╡·││
││····││·   ╚══════╝   ·││····││
└╘═╕┐·││·┌┐          ┌┐·││·┌╒═╛┘
   ││·└┘·└╘═╡ ┌──┐ ╞═╛┘·└┘·││   
   ││·········│  │·········││   
═══╛┘·╞══╕╒═╡·└──┘·╞═╕╒══╡·└╘═══
     ····││···    ···││····     
╕╒══╡·┌┐·└┘·╞══╕╒══╡·└┘·┌┐·╞══╕╒
││■···││·······││·······││···■││
││·╞══╛┘·╞═══╡·└┘·╞═══╡·└╘══╡·││
││····························││
└╘════════════════════════════╛┘
┌╒══════════╕╒════╕╒══════════╕┐
││··········││····││··········││
││■┌╒═════╡·└┘·┌┐·└┘·╞═════╕┐■││
││·└┘··········││··········└┘·││
││····┌┐·┌───┐·││·┌───┐·┌┐····││
╛╘══╡·││·└───┘·└┘·└───┘·││·╞══╛╘
  ····││················││····  
╕┐·┌┐ └╘══╡ ╞══════╡ ╞══╛┘ ┌┐·┌╒
││·││                      ││·││
││·└╘══╡ ┌┐ ╔══≡≡══╗ ┌┐ ╞══╛┘·││
││·      ││ ║      ║ ││      ·││
││·┌┐ ╞══╛┘ ╚══════╝ └╘══╡ ┌┐·││
││·││                      ││·││
││·└╘══╡ ┌╒══╡ ┌┐ ╞══╕┐ ╞══╛┘·││
││·······││    ││    ││·······││
│╞══╡·┌┐·└┘ ╞══╛╘══╡ └┘·┌┐·╞══╡│
││■···││······    ······││···■││
││·╞══╛┘·┌╒══╡ ┌┐ ╞══╕┐·└╘══╡·││
││·······││····││····││·······││
││·╞═══╡·││·╞══╛╘══╡·││·╞═══╡·││
││·······││··········││·······││
└╘═══════╛╘══════════╛╘═══════╛┘
┌╒════════════════════════════╕┐
││····························││
││■┌┐·┌───┐·┌╒════╕┐·┌───┐·┌┐■││
││·││·└───┘·││····││·└───┘·││·││
││·││·······││·┌┐·││·······││·││
││·└╘══╡·┌┐·└┘·││·└┘·┌┐·╞══╛┘·││
││·······││····││····││·······││
└╘═╕┐·╞══╡╞══╡ └┘ ╞══╡╞══╡·┌╒═╛┘
═══╛┘····││          ││····└╘═══
      ┌┐·└┘ ╔══≡≡══╗ └┘·┌┐      
══════╡│·   ║      ║   ·│╞══════
      └┘·┌┐ ╚══════╝ ┌┐·└┘      
═══╕┐····││          ││····┌╒═══
   ││·┌┐·└╘══╡ ┌┐ ╞══╛┘·┌┐·││   
   ││·││····   ││   ····││·││   
┌╒═╛┘·└╘══╡·┌┐ └┘ ┌┐·╞══╛┘·└╘═╕┐
││■·········││    ││·········■││
││·┌╒══╡·┌┐·└╘════╛┘·┌┐·╞══╕┐·││
││·││····││··········││····││·││
││·└┘·╞══╛╘══╡·┌┐·╞══╛╘══╡·└┘·││
││·············││·············││
└╘═════════════╛╘═════════════╛┘
┌╒══════════╕╒════╕╒══════════╕┐
││··········││····││··········││
││■┌╒═════╡·└┘·┌┐·└┘·╞═════╕┐■││
││·└┘··········││··········└┘·││
││····┌┐·┌───┐·││·┌───┐·┌┐····││
╛╘══╡·││·└───┘·└┘·└───┘·││·╞══╛╘
  ····││················││····  
╕┐·┌┐ └╘══╡ ╞══════╡ ╞══╛┘ ┌┐·┌╒
││·││                      ││·││
││·└╘══╡ ┌┐ ╔══≡≡══╗ ┌┐ ╞══╛┘·││
││·      ││ ║      ║ ││      ·││
││·┌┐ ╞══╛┘ ╚══════╝ └╘══╡ ┌┐·││
││·││                      ││·││
││·└╘══╡ ┌╒══╡ ┌┐ ╞══╕┐ ╞══╛┘·││
││·······││    ││    ││·······││
│╞══╡·┌┐·└┘ ╞══╛╘══╡ └┘·┌┐·╞══╡│
││■···││······    ······││···■││
││·╞══╛┘·┌╒══╡ ┌┐ ╞══╕┐·└╘══╡·││
││·······││····││····││·······││
││·╞═══╡·││·╞══╛╘══╡·││·╞═══╡·││
││·······││··········││·······││
└╘═══════╛╘══════════╛╘═══════╛┘
┌╒════════════════════════════╕┐
││····························││
││■┌┐·┌───┐·┌╒════╕┐·┌───┐·┌┐■││
││·││·└───┘·││····││·└───┘·││·││
││·││·······││·┌┐·││·······││·││
││·└╘══╡·┌┐·└┘·││·└┘·┌┐·╞══╛┘·││
││·······││····││····││·······││
└╘═╕┐·╞══╡╞══╡ └┘ ╞══╡╞══╡·┌╒═╛┘
═══╛┘····││          ││····└╘═══
      ┌┐·└┘ ╔══≡≡══╗ └┘·┌┐      
══════╡│·   ║      ║   ·│╞══════
      └┘·┌┐ ╚══════╝ ┌┐·└┘      
═══╕┐····││          ││····┌╒═══
   ││·┌┐·└╘══╡ ┌┐ ╞══╛┘·┌┐·││   
   ││·││····   ││   ····││·││   
┌╒═╛┘·└╘══╡·┌┐ └┘ ┌┐·╞══╛┘·└╘═╕┐
││■·········││    ││·········■││
││·┌╒══╡·┌┐·└╘════╛┘·┌┐·╞══╕┐·││
││·││····││··········││····││·││
││·└┘·╞══╛╘══╡·┌┐·╞══╛╘══╡·└┘·││
││·············││·············││
└╘═════════════╛╘═════════════╛┘
