1 32x23 READY="READY!" GAMEOVER=" GONE " PLAYER1="ONE UP" PLAYER2="TWO UP" RGHOST=12.5 ROGHOST=2 COGHOST=1 CGHOST=16 RFRUIT=11.5 RTOP=11.5 RHERO=11.5 CHERO=19.5 RMSG=14 CMSG=13 RMSG2=8 CMSG2=13 ABOUT="Inspired by TI's 'Munch Man' TI-99/4A game"
 ┌────────────────────────────┐ 
 │····························│ 
 │■╞═╕─┐·┌─╒════════╕─┐·┌─╒═╡■│ 
 │···│ │·│ │········│ │·│ │···│ 
 └─┐·│ │·│ │·┌────┐·│ │·│ │·┌─┘ 
   │·│ │·│ │·│    │·│ │·│ │·│   
───┘·└─┘·└─┘·└────┘·└─┘·└─┘·└───
································
───┐·┌─┐·┌─┐·┌────┐·┌─┐·┌─┐·┌───
   │·│ │·│ │·╓────╖·│ │·│ │·│   
   │·│ │·└─┘·╨    ╨·└─┘·│ │·│   
   │·│ │·····      ·····│ │·│   
   │·│ │·┌─┐·╥    ╥·┌─┐·│ │·│   
   │·│ │·│ │·╙────╜·│ │·│ │·│   
 ┌─┘·└─┘·└─┘·└────┘·└─┘·└─┘·└─┐ 
 │····························│ 
 │■╞════╡·┌──┐·┌┐·┌──┐·╞════╡■│ 
 │········│┌─┘·││·└─┐│········│ 
 └─┐·╞══╡·││···││···││·╞══╡·┌─┘ 
   │······││·┌─┘└─┐·││······│   
───┘·┌──┐·└┘·└────┘·└┘·┌──┐·└───
·····│  │··············│  │·····
─────┘  └──────────────┘  └─────
