1 30x22 RGHOST=10.5 ROGHOST=1 RFRUIT=12.5 RTOP=8.5 RHERO=16.5 RMSG=12 CMSG=10 RMSG2=8 CMSG2=10 ABOUT="Inspired by the TI-99/4A conversion of Pac-Man"
┌╒════════════╕╒════════════╕┐
││············││············││
││·┌──┐·┌───┐·││·┌───┐·┌──┐·││
││■└──┘·└───┘·└┘·└───┘·└──┘■││
││··························││
││·╞══╡·┌┐·╞══╕╒══╡·┌┐·╞══╡·││
││······││····││····││······││
└╘═══╕┐·│╞══╡ └┘ ╞══╡│·┌╒═══╛┘
     ││·││          ││·││     
═════╛┘·└┘ ╔══≡≡══╗ └┘·└╘═════
           ║      ║           
═════╕┐·┌┐ ╚══════╝ ┌┐·┌╒═════
     ││·││          ││·││     
┌╒═══╛┘·└┘ ╞══╕╒══╡ └┘·└╘═══╕┐
││············││············││
││·╞═╕┐·╞═══╡·└┘·╞═══╡·┌╒═╡·││
││■··││·······  ·······││··■││
│╞═╡·└┘·┌┐·╞══╕╒══╡·┌┐·└┘·╞═╡│
││······││····││····││······││
││·╞════╛╘══╡·└┘·╞══╛╘════╡·││
││··························││
└╘══════════════════════════╛┘
