1 36x22 RGHOST=10.5 ROGHOST=1 RFRUIT=12.5 RTOP=8.5 RHERO=16.5 RMSG=12 CMSG=13 RMSG2=8 CMSG2=13 ABOUT="Inspired by Atari's 5200 and C64 conversions of Pac-Man"
╔════════════════╕╒════════════════╗
║················││················║
║·┌───┐·┌──────┐·││·┌──────┐·┌───┐·║
║■└───┘·└──────┘·└┘·└──────┘·└───┘■║
║··································║
║·╞═══╡·┌─┐·╞════╕╒════╡·┌─┐·╞═══╡·║
║·······│ │······││······│ │·······║
╚═════╗·│ ╞════╡ └┘ ╞════╡ │·╔═════╝
      ║·│ │              │ │·║      
══════╝·└─┘ ╔════≡≡════╗ └─┘·╚══════
       ·    ║          ║    ·       
══════╗·┌─┐ ╚══════════╝ ┌─┐·╔══════
      ║·│ │              │ │·║      
╔═════╝·└─┘ ╞════╕╒════╡ └─┘·╚═════╗
║················││················║
║·╞══╕┐·╞══════╡·└┘·╞══════╡·┌╒══╡·║
║■···││··········  ··········││···■║
╠══╡·└┘·┌─┐·╞════╕╒════╡·┌─┐·└┘·╞══╣
║·······│ │······││······│ │·······║
║·╞═════╛─╘════╡·└┘·╞════╛─╘═════╡·║
║··································║
╚══════════════════════════════════╝
