1 19x21 READY=" READY!" GAMEOVER=" GONE  " PLAYER1=" P ONE " PLAYER2=" P TWO " RGHOST=9.5 ROGHOST=2 COGHOST=1 RFRUIT=11.5 RTOP=7.5 RHERO=15.5 RMSG=11 CMSG=6 CMSG2=6 ABOUT="Inspired by the 'Pac-Box' level for Descent 3"
╔════════╦════════╗
║········║········║
║■╞╡·╞═╡·╨·╞═╡·╞╡■║
║·················║
║·╞╡·╥·╞═╦═╡·╥·╞╡·║
║····║···║···║····║
╚══╗·╠═╡·╨·╞═╣·╔══╝
   ║·║       ║·║   
   ║·╨ ╔╡ ╞╗ ╨·║   
   ║·· ║   ║ ··║   
   ║·╥ ╚═══╝ ╥·║   
   ║·║       ║·║   
╔══╝·╨·╞═╦═╡·╨·╚══╗
║········║········║
║·╞╗·╞═╡·╨·╞═╡·╔╡·║
║■·║···········║·■║
╠╡·╨·╥·╞═╦═╡·╥·╨·╞╣
║····║···║···║····║
║·╞══╩═╡·╨·╞═╩══╡·║
║·················║
╚═════════════════╝
