1 30x33 ROGHOST=1 COGHOST=1.5 RFRUIT=18.5 RTOP=12.5 RHERO=24.5 RMSG=18 CMSG=10 RMSG2=12 CMSG2=10 ABOUT="A maze inspired by Toru Iwatani/Namco's Pac-Man/Puckman (converted to match 'mspaccdi')"
┌────────────────────────────┐
│┌────────────┐┌────────────┐│
││············││············││
││·┌──┐·┌───┐·││·┌───┐·┌──┐·││
││■│╞╡│·│╞═╡│·││·│╞═╡│·│╞╡│■││
││·└──┘·└───┘·└┘·└───┘·└──┘·││
││··························││
││·┌──┐·┌┐·┌──────┐·┌┐·┌──┐·││
││·└──┘·││·└──┐┌──┘·││·└──┘·││
││······││····││····││······││
│└────┐·│└──┐ ││ ┌──┘│·┌────┘│
└────┐│·│┌──┘ └┘ └──┐│·│┌────┘
     ││·││          ││·││     
─────┘│·││ ┌─┐  ┌─┐ ││·│└─────
──────┘·└┘ │┌┘  └┐│ └┘·└──────
       ·   ││    ││   ·       
──────┐·┌┐ │└────┘│ ┌┐·┌──────
─────┐│·││ └──────┘ ││·│┌─────
     ││·││          ││·││     
┌────┘│·││ ┌──────┐ ││·│└────┐
│┌────┘·└┘ └──┐┌──┘ └┘·└────┐│
││············││············││
││·┌──┐·┌───┐·││·┌───┐·┌──┐·││
││·└─┐│·└───┘·└┘·└───┘·│┌─┘·││
││■··││·······  ·······││··■││
│└─┐·││·┌┐·┌──────┐·┌┐·││·┌─┘│
│┌─┘·└┘·││·└──┐┌──┘·││·└┘·└─┐│
││······││····││····││······││
││·┌────┘└──┐·││·┌──┘└────┐·││
││·└────────┘·└┘·└────────┘·││
││··························││
│└──────────────────────────┘│
└────────────────────────────┘
