1 40x24 RFRUIT=16.5 RTOP=10.5 RHERO=18.5 RMSG=16 CMSG=15 RMSG2=16 CMSG2=15 ABOUT="Inspired by Al J. Jimenez's 'Pac-Gal' (a text-mode game for DOS)" FIXME="ghosts get stuck in the bottom corners"
╔════════╦═════════╦═════════╦═════════╗
║········║·····■···║·····■···║·········║
║·╥·╔══╡·╨·╞═══╦═╡·║·╞═╦═══╡·╨·╞═══╗·╥·║
║·║·║··········║···║···║···········║·║·║
║·║·╨·╞══════╡·╨·╞═╩═╡·╨·╞═══════╡·╨·║·║
║■║··································║■║
║·║·╞═══╡·╞══╗·╔═══╦═══╦═╡·╔═╡·╞═══╡·║·║
║·║·········╔╝·╨···╨···╨···║·········║·║
║·╨·╥·╞═══╗·║····╥···╥···╥·║·╔═══╡·╥·╨·║
║···║·····╨·║·╥·╞╩═══╩═╡·║·║·╨·····║···║
╩═══╝·╥·╥···║·║··········║·║···╥·╥·╚═══╩
  ····║·║■╥·║·╨·╔══≡≡══╗·╨·║·╥■║·║····  
╦═══╗·╨·║·║·║···║      ║···║·║·║·╨·╔═══╦
║···║···╨·║·║·╥·║      ║·╥·║·║·╨···║···║
║·╥·║·╥···║·║·║·║      ║·║·║·║···╥·║·╥·║
║·║·╨·╚═╡·║·╨·╨·╚══════╝·╨·╨·║·╞═╝·╨·║·║
║·║·······║··················║·······║·║
║·║·╞═════╝·╞══════════════╡·╚═════╡·║·║
║■║················ ·················║■║
║·║·╥·╞══════╡·╥·╞═╦═╡·╥·╞═══════╡·╥·║·║
║·║·║··········║···║···║···········║·║·║
║·╨·╚══╡·╥·╞═══╩═╡·║·╞═╩═══╡·╥·╞═══╝·╨·║
║········║·····■···║·····■···║·········║
╚════════╩═════════╩═════════╩═════════╝
