1 41x31 \
 RTOP=10.5 \
 RGHOST=15.5 CGHOST=20.5 ROGHOST=6 COGHOST=3 \
 RHERO=21.5 CHERO=17.5 DIRHERO=RIGHT \
 RFRUIT=21.5 CFRUIT=17.5 \
 RMSG=17 CMSG=17 \
 RMSG2=13 CMSG2=17 \
   READY=" READY!" \
 PLAYER1=" P ONE " \
 PLAYER2=" P TWO " \
GAMEOVER="GOODBYE" \
 ABOUT="Inspired by Clint M \"firelord84\" Frederickson and Mike Emery's 'PacmanX' game"
╔═══════════╗ ╔═══════╗   ╔═════════════╗
║■··········║ ║·······║   ║············■║
║·┌───┐·┌─┐·║ ║·┌───┐·║   ║·┌───┐·┌───┐·║
║·│   │·│ │·║ ║·│   │·║   ║·│   │·│   │·║
║·│   │·│ │·╚═╝·└─┐ │·╚═══╝·│   │·│   │·║
║·│   │·│ │·······│ │·······│   │·│   │·║
║·└───┘·│ └─────┐·│ └─┐·┌───┘ ┌─┘·└─┐ │·║
║·······│       │·│   │·│     │·····│ │·║
║·┌───┐·└───────┘·└───┘·└───┐ │·┌─┐·│ │·║
║·│   │·····················│ │·│ │·│ │·║
║·│   │·┌───┐·┌───┐   ┌───┐·└─┘·│ │·└─┘·║
║·│   │·│   │·│   ╞≡≡≡╡   │·····│ │·····║
║·│   │·└───┘·│ ┌─┘   └─┐ │·┌───┘ └─┐·╔═╝
║·│   │·······│ │       │ │·│       │·║  
║·└───┘·┌───┐·│ │       │ │·└───────┘·║  
║·······│   │·│ │       │ │···········║  
║·┌───┐·└───┘·│ │       │ │·┌───────┐·║  
║·│   │·······│ │       │ │·│       │·║  
║·│   │·┌───┐·│ └───────┘ │·└───┐ ┌─┘·╚═╗
║·│   │·│   │·│           │·····│ │·····║
║·│   │·└───┘·└───────────┘·┌─┐·│ │·┌─┐·║
║·│   │·········· ··········│ │·│ │·│ │·║
║·└───┘·┌───────┐·┌───┐·┌───┘ │·└─┘·│ │·║
║·······│       │·│   │·│     │·····│ │·║
║·┌───┐·│ ┌─────┘·│ ┌─┘·└───┐ └─┐·┌─┘ │·║
║·│   │·│ │·······│ │·······│   │·│   │·║
║·│   │·│ │·╔═╗·┌─┘ │·╔═══╗·│   │·│   │·║
║·│   │·│ │·║ ║·│   │·║   ║·│   │·│   │·║
║·└───┘·└─┘·║ ║·└───┘·║   ║·└───┘·└───┘·║
║■··········║ ║·······║   ║············■║
╚═══════════╝ ╚═══════╝   ╚═════════════╝
