1 29x29 RGHOST=13.5 ROGHOST=1 RFRUIT=15.5 RTOP=11.5 RHERO=21.5 RMSG=15 RMSG2=15 ABOUT="Inspired by 'Pac-Manic' (a game for DOS)"
╔════════════╕═╒════════════╗
║············│ │············║
║·┌──┐·┌───┐·│ │·┌───┐·┌──┐·║
║■│  │·│   │·│ │·│   │·│  │■║
║·└──┘·└───┘·└─┘·└───┘·└──┘·║
║···························║
║·┌──┐·┌┐·┌───────┐·┌┐·┌──┐·║
║·└──┘·││·└──┐ ┌──┘·││·└──┘·║
║······││····│ │····││······║
╚════╗·│└──┐·│ │·┌──┘│·╔════╝
     ║·│┌──┘·└─┘·└──┐│·║     
     ║·││           ││·║     
═════╝·└┘ ╔══≡≡≡══╗ └┘·╚═════
      ·   ║       ║   ·      
═════╗·┌┐ ╚═══════╝ ┌┐·╔═════
     ║·││           ││·║     
     ║·││ ┌───────┐ ││·║     
╔════╝·└┘ └──┐ ┌──┘ └┘·╚════╗
║············│ │············║
║·┌──┐·┌───┐·│ │·┌───┐·┌──┐·║
║·└─┐│·└───┘·└─┘·└───┘·│┌─┘·║
║■··││········ ········││··■║
╙─┐·││·┌┐·┌───────┐·┌┐·││·┌─╜
╓─┘·└┘·││·└──┐ ┌──┘·││·└┘·└─╖
║······││····│ │····││······║
║·┌────┘└──┐·│ │·┌──┘└────┐·║
║·└────────┘·└─┘·└────────┘·║
║···························║
╚═══════════════════════════╝
