1 51x23 RHERO=18.5 RFRUIT=12.5 RGHOST=10.5 RTOP=8.5 RMSG=12 CMSG=21 RMSG2=7 CMSG2=21 READY=" READY!! " PLAYER1=" PLAYER 1" PLAYER2=" PLAYER 2" GAMEOVER="GAME OVER" WALL_COLORS="\x03" MORTAR_COLORS="\x07" DOT_COLORS="\x0E" ABOUT="Inspired by Ken Siders's 'Pac Munch Jr.'"
╔══════╦══════════════╦╦═══╦╦══════════════╦══════╗
║······║··············║║···║║··············║······║
║·╔╦═╡·║·╔═══╗·╥·╞╡·╥·╚╝·╥·╚╝·╥·╞╡·╥·╔═══╗·║·╞═╦╗·║
║·║║···║·║   ║·║····║····║····║····║·║   ║·║···║║·║
║·╚╝■╥·║·╚═══╝·║·╞══╬══╡·║·╞══╬══╡·║·╚═══╝·║·╥■╚╝·║
║····║·║······■║····║····║····║····║■······║·║····║
║·╔╦═╝·║·╞═════╩══╡·╨·╞══╩══╡·╨·╞══╩═════╡·║·╚═╦╗·║
║·║║···║···········             ···········║···║║·║
║·╚╝·╥·╨·╥·╞════════╡ ╔══≡══╗ ╞════════╡·╥·╨·╥·╚╝·║
║····║···║·········   ║     ║   ·········║···║····║
╠══╡·║·╞═╬═╡·╔═╗·╞══╡ ║     ║ ╞══╡·╔═╗·╞═╬═╡·║·╞══╣
║····║···║■··║ ║···   ╚═════╝   ···║ ║··■║···║····║
║·╞══╩═╡·╨·╥·╚═╝·╥·╔╗         ╔╗·╥·╚═╝·╥·╨·╞═╩══╡·║
║··········║·····║·╚╩╡ ╞═╦═╡ ╞╩╝·║·····║··········║
║·╥·╞══╗·╥·╠═══╡·║·······║·······║·╞═══╣·╥·╔══╡·╥·║
║·║····║·║·║·····║·╔═══╗·║·╔═══╗·║·····║·║·║····║·║
║·╚╡·╥·║·║·╨·╞═══╣·║   ║·║·║   ║·╠═══╡·╨·║·║·╥·╞╝·║
║····║·╨·║·······║·╚═══╝·╨·╚═══╝·║·······║·╨·║····║
╠══╡■║···║·╥·╔═╡·╨····       ····╨·╞═╗·╥·║···║■╞══╣
║····╠═╡·║·║·║·····╔╗·╔═════╗·╔╗·····║·║·║·╞═╣····║
║·╞══╝···╨·║·╨·╞═══╩╝·╨·····╨·╚╩═══╡·╨·║·╨···╚══╡·║
║······╥···║············╔═╗············║···╥······║
╚══════╩═══╩════════════╩═╩════════════╩═══╩══════╝
