1 32x22 RGHOST=10.5 ROGHOST=1 RFRUIT=12.5 RTOP=9 RHERO=16.5 RMSG=12 CMSG=11 RMSG2=8 CMSG2=11 ABOUT="Inspired by Atari's PC conversion of Pac-Man"
╔══════════════╕╒══════════════╗
║··············││··············║
║·┌──┐·┌─────┐·││·┌─────┐·┌──┐·║
║■└──┘·└─────┘·└┘·└─────┘·└──┘■║
║······························║
║·╞══╡·┌┐·╞════╕╒════╡·┌┐·╞══╡·║
║······││······││······││······║
╚════╗·│╞════╡ └┘ ╞════╡│·╔════╝
     ║·││              ││·║     
═════╝·└┘ ╔════≡≡════╗ └┘·╚═════
      ·   ║          ║   ·      
═════╗·┌┐ ╚══════════╝ ┌┐·╔═════
     ║·││              ││·║     
╔════╝·└┘ ╞════╕╒════╡ └┘·╚════╗
║··············││··············║
║·╞══╗·╞═════╡·└┘·╞═════╡·╔══╡·║
║■···║·········  ·········║···■║
╠══╡·╨·┌┐·╞════╕╒════╡·┌┐·╨·╞══╣
║······││······││······││······║
║·╞════╛╘════╡·└┘·╞════╛╘════╡·║
║······························║
╚══════════════════════════════╝
