20 21x15 RGHOST=5.5,7.5,7.5,13.5,4.5,6.5,1.5,10.5,7.5,7.5,10.5,7.5,4.5,4.5,11.5,4.5,6.5,7.5,11.5,3.5 CGHOST=10.5,10.5,17.5,10.5,3.5,10.5,10.5,10.5,10.5,5.5,17.5,10.5,10.5,10.5,4.5,10.5,10.5,5.5,4.5,10.5 RHERO=9.5,12.5,7.5,4.5,9.5,4.5,8.5,5.5,11.5,7.5,6.5,7.5,9.5,10.5,3.5,10.5,10.5,7.5,11.5,9.5 CHERO=10.5,10.5,5.5,10.5,14.5,10.5,10.5,10.5,10.5,13.5,8.5,14.5,10.5,10.5,4.5,10.5,10.5,11.5,16.5,10.5 RFRUIT=9.5,12.5,7.5,4.5,9.5,4.5,8.5,5.5,11.5,7.5,6.5,7.5,9.5,10.5,3.5,10.5,10.5,7.5,11.5,9.5 CFRUIT=10.5,10.5,5.5,10.5,14.5,10.5,10.5,10.5,10.5,13.5,8.5,14.5,10.5,10.5,4.5,10.5,10.5,11.5,16.5,10.5 READY=" READY!" GAMEOVER="GOODBYE" PLAYER1="PLAYER1" PLAYER2="PLAYER2" CMSG=7 RMSG=14 CMSG2=7 RMSG2=0 RTOP=4.5,6.5,5.5,12.5,2.5,6.5,1.5,10.5,6.5,5.5,7.5,5.5,3.5,3.5,10.5,3.5,5.5,5.5,10.5,1.5 ROGHOST=2,2,1,2,1,-2,-2,-2,2,1,1,1,2,2,2,2,2,1,2,2 COGHOST=1,1,0,1,0,1,1,1,1,0,0,0,1,1,1,1,1,0,1,1 ABOUT="Inspired by Wayne Price/Ruckage's 'Ruck-Man'"
╔═══════════════════╗
║■·················■║
║·╥·╞═╗·╞═══╡·╔═╡·╥·║
║·║···║·······║···║·║
╝·╨·╥·╨·╔═≡═╗·╨·╥·╨·╚
 ···║···║: :║···║··· 
╗·╞═╝·╥·╚═══╝·╥·╚═╡·╔
║·····║·······║·····║
║·┌┐·╞╝·╞╡·╞╡·╚╡·┌┐·║
║·││······ ······││·║
║·││·╥·╞══╦══╡·╥·││·║
║·││·║····║····║·││·║
║·└┘·╚══╡·╨·╞══╝·└┘·║
║■·················■║
╚═══════════════════╝
╔════════╣ ╠════════╗
║········╨·╨········║
║·┌┐·╞═╗·····╔═╡·┌┐·║
║·└┘··■║·┌─┐·║■··└┘·║
║····╥·╨·└─┘·╨·╥····║
║·╞╡·║·········║·╞╡·║
║····╚╡·╔═≡═╗·╞╝····║
║·╞╡····║: :║····╞╡·║
║····╔╡·╚═══╝·╞╗····║
║·╞╡·║·········║·╞╡·║
║····╨·╥·╥·╥·╥·╨····║
║·┌┐··■║·╨·╨·║■··┌┐·║
║·└┘·╞═╝·· ··╚═╡·└┘·║
║········╥·╥········║
╚════════╣ ╠════════╝
╔═════════╦═══╦═════╗
║■········╨···║■····║
║·╞═╗·╔═╡···╥·╨·╞═╗·║
║···║·║···•·╨·····╨·║
║·╥·║·╨·╥·····╥·╥···║
║·╨·╨···╨·┌─┐·║·╠≡╗·║
║·····╥···│ │·╨·║ ║·║
║·╞═╡ ╠═╡·│ │···║ ║·║
║·····╨···│ │·╥·║:║·║
║·╥·╥···╥·└─┘·║·╠═╝·║
║·╨·║·╥·╨·····╨·╨···║
║···║·║···•·╥·····╥·║
║·╞═╝·╚═╡···╨·╥·╞═╝·║
║■········╥···║■····║
╚═════════╩═══╩═════╝
╔═══════╦═══╦═══════╗
║·······║···║·······║
║·╞╗·┌┐·║·╥·║·┌┐·╔╡·║
║·■║·└┘·╨·╨·╨·└┘·║■·║
╠╡·║······ ······║·╞╣
║··║·╥·┌┐╞═╡┌┐·╥·║··║
║·╞╝·╨·└┘···└┘·╨·╚╡·║
║·········╥·········║
║·╞══╡·╞╡·║·╞╡·╞══╡·║
║·········║·········║
╚╡·╔═╡·╞══╩══╡·╞═╗·╞╝
 ··║■···········■║·· 
═╗·╨·╞╡·╔═≡═╗·╞╡·╨·╔═
 ║······║: :║······║ 
 ╚══════╩═══╩══════╝ 
╔═════╦══╝ ╚════════╗
║■····╨············■║
║·╔≡╗···╔═╡·╥·╥·╥·╥·║
║·║ ║·╥·║···║·╨·║·║·║
║·║ ║·║·║·╞═╝···╨·║·║
║·║:║·╨·╨·····╥···╨·║
║·╚═╝·····╥·╞═╝·╥···║
║·····╥·╥·║·····║·╥·║
║·╞═══╝·╨·║·╞═══╝·║·║
║·········║··· ···║·║
║·╥·╞╡·╞══╝·╔═══╦═╝·║
║·║■········║···║■··║
║·╚═╡·╞═══╡·╨·╥·╨·•·║
║·············║·····║
╚════════╗ ╔══╩═════╝
╔════════╝ ╚════════╗
║···················║
║·╥·╞═╡·╥·╥·╥·╞═╡·╥·║
║·║■····╨·╨·╨····■║·║
║·╚═══╡··· ···╞═══╝·║
║·······╔═══╗·······║
║·╥·╞═╗·║: :║·╔═╡·╥·║
║·║···║·╚╡ ╞╝·║···║·║
║·╚═╗·╨·······╨·╔═╝·║
║···╨···•┌─┐•···╨···║
║·•■··•··└─┘··•··■•·║
║·┌┐·┌─┐·····┌─┐·┌┐·║
║·└┘·└─┘·•·•·└─┘·└┘·║
║···················║
╚════════╗ ╔════════╝
╔═══════╦═══╦═══════╗
║■······║: :║······■║
║·┌┐╞═╡·╚╡ ╞╝·╞═╡┌┐·║
╝·└┘·············└┘·╚
 ····╞╦╡·╞╦╡·╞╦╡···· 
╒╡·╥··║···╨···║··╥·╞╕
│··╠╡·║·╥···╥·║·╞╣··│
│·╞╣··║·║·╞═╣·║··╠╡·│
│··║·╞╝·║· ·║·╚╡·║··│
╘╡·╨····╠═╡·║····╨·╞╛
 ····╞╡·╨···╨·╞╡···· 
╗·┌┐······╥······┌┐·╔
║·└┘╞═╡·╞═╩═╡·╞═╡└┘·║
║■·················■║
╚═══════════════════╝
╔════════╦══════════╗
║········║··········║
║·╞╡·╞═╡·╨·╥·╞══╡·╥·║
║■·········║······║■║
╠═╡·╥·╔╡·╞═╝·╞╗·╥·║·║
║···║·║··· ···║·║·║·║
║·╞═╣·║·┌┐·┌┐·║·║·║·║
║···╨·╨·└┘·└┘·╨·╨·╨·║
║·╥·················║
║·╠╡·╞╗·╔═══╗·╔╡·╞╗·║
║·║■··║·║: :║·║··■║·║
║·║·╥·║·╚╡ ╞╝·║·╥·║·║
║·╨·╨·╨·······╨·╨·╨·║
║·······╔═══╗·······║
╚═══════╝   ╚═══════╝
╔════════╣ ╠════════╗
║■·······║·║·······■║
║·╥·╔══╡·╨·╨·╞══╗·╥·║
║·╨·╨···········╨·╨·║
║·····╥·╞═══╡·╥·····║
╚╗·┌┐·║·······║·┌┐·╔╝
═╝·└┘·╨·╔═≡═╗·╨·└┘·╚═
 ·······║: :║······· 
╦╡·╞══╡·╚═══╝·╞══╡·╞╦
║···················║
║·╞╡·╞╡·╞╡·╞╡·╞╡·╞╡·║
║········· ·········║
║·╞═══╡·╞═══╡·╞═══╡·║
║······■·····■······║
╚════════╗ ╔════════╝
╔═════╣ ╠══════╦════╗
║■····╨·╨······╨···■║
║·╥·╥·····╥·╞╡···┌┐·║
║·║·╚═══╡·║····╥·└┘·║
║·║·······║·╞══╝····║
║·║·╔≡╗·╥·╨······╔╡·║
║·╨·║ ║·║···╥·╞╡·║··║
║···║ ║·╠═╡·║ ···║·╞╣
║·╥·║:║·║···╨·╞╡·║··║
║·║·╚═╝·╨·╥······╚╡·║
║·║·······║·╞══╗····║
║·║·╔═══╡·║····╨·┌┐·║
║·╨·╨·····╨·╞╡···└┘·║
║■····╥·╥······╥···■║
╚═════╣ ╠══════╩════╝
╔═════╦═════════════╗
║·····╨·············║
║·•·╥···╥·•·╥·╥·╥·•·║
║··■║·╞═╝···║·║·║■··║
║·╞═╝·····╥·╨·╨·╚═╡·║
║··╞╡·╞═══╝·········║
╩╡······ ···╥·╔═╡·╞═╩
 ··╥·╔═╡·╥·╞╣·╨····· 
╦╡·║·╨···║··╨···╔≡╗·╔
║··║···╥·║╥···╥·║ ║·║
║·╞╩╗·╞╝·╚╝·╞═╣·║ ║·║
║··■║·········╨·║:║·║
║·•·╨·╞══╡·╞╡···╚═╝·║
║············■╥·····║
╚═════════════╩═════╝
╔═════╦══════╣ ╠═══╗ 
║····■╨······╨·╨··■║ 
║·╔═╡···┌──┐·····╥·║ 
║·║···•·└──┘·╔═╡·║·╚╗
║·╨·╥········║···║··║
║···╨·╞╗·╔≡╗·║·╥·╚╡·║
║·╥····║·║ ║·╨·║····║
║·╠╡·•·║·║ ║·· ╠╡·╞═╣
║·╨····║·║:║·╥·║····║
║···╥·╞╝·╚═╝·║·╨·╔╡·║
║·╥·╨········║···║··║
║·║···•·┌──┐·╚═╡·║·╔╝
║·╚═╡···└──┘·····╨·║ 
║····■╥······╥·╥··■║ 
╚═════╩══════╣ ╠═══╝ 
 ╔═════╗     ╔═════╗ 
 ║■····╚═════╝····■║ 
 ║·┌─┐·········┌─┐·║ 
 ║·│ └┐·╔═≡═╗·┌┘ │·║ 
 ║·└─┐│·║: :║·│┌─┘·║ 
═╝···└┘·╚═══╝·└┘···╚═
 ··╥····•···•····╥·· 
╦╡·╚══╡···╥···╞══╝·╞╦
║·······╞═╩═╡·······║
║·╥·╞═╡··· ···╞═╡·╥·║
║·╨··╞═══╡·╞═══╡··╨·║
║·┌┐·············┌┐·║
║·└┘·╞╡·╞═══╡·╞╡·└┘·║
║■·················■║
╚═══════════════════╝
╔═══╝ └─┐   ┌─┘ ╚═══╗
║■······└───┘······■║
║·┌─┐·╥·······╥·┌─┐·║
║·└─┘·║·╔═≡═╗·║·└─┘·║
║·····║·║: :║·║·····║
║·┌─┐·╨·╚═══╝·╨·┌─┐·║
║·│ │···········│ │·║
║·└─┘·╞═╡·╥·╞═╡·└─┘·║
║·········║·········║
║·╥·╔══╡·╞╩╡·╞══╗·╥·║
║·║·║····· ·····║·║·║
║·║·║·╞╡·┌─┐·╞╡·║·║·║
║·╨·╨····└─┘····╨·╨·║
║■····┌┐·····┌┐····■║
╚═══╗ │└─────┘│ ╔═══╝
╔═══════╦═══╦═══╦═══╗
║■······║···╨···║··■║
║·╞╡·╞╡·╨·╥···╥·╨·•·║
║··· ·····║·╞═╝·····║
║·╞════╗·╞╝······╥·╞╣
║······║····╥·┌┐·╨··║
║·╥·╞╡·╨·╞══╝·└┘·┌┐·║
╝·║··············└┘·╚
 ·╨·╞═╡·╥·╞═╡·╞╡···· 
╗·······║········╥·╔═
║·╔═≡═╗·╠══╡·╞╦╡·╨·╚╗
║·║: :║·║·····║·····║
║·╚═══╝·╨·╔═╗·╨·╥·•·║
║■········║ ║···║··■║
╚═════════╝ ╚═══╩═══╝
  ╔════╗     ╔════╗  
  ║■···╚═════╝···■║  
══╝·╞╗·········╔╡·╚══
 ····╠╡·╔═≡═╗·╞╣···· 
┐·╔╡·╨··║: :║··╨·╞╗·┌
│·║····•╚═══╝•····║·│
│·║·╔╡·········╞╗·║·│
│·║·║··╔╡·╥·╞╗··║·║·│
│·╨·╨·╞╝··║··╚╡·╨·╨·│
│········╞╩╡········│
┘·╞═╗·┌┐·· ··┌┐·╔═╡·└
 ··■║·││·┌─┐·││·║■·· 
══╗·╨·└┘·└─┘·└┘·╨·╔══
  ║···············║  
  ╚═══════════════╝  
╔═══════╗║ ║╔═══════╗
║■······╚╝·╚╝······■║
║·┌┐·┌┐·······┌┐·┌┐·║
║·└┘·└┘•·╞═╡·•└┘·└┘·║
║···················║
╚╗·╥·╞╡·╔═≡═╗·╞╡·╥·╔╝
═╝·║····║: :║····║·╚═
 ··╠══╡·╚═╦═╝·╞══╣·· 
═╗·║······║······║·╔═
╔╝·╨·╞╡·•·╨·•·╞╡·╨·╚╗
║········· ·········║
║·┌┐·┌┐•·╞═╡·•┌┐·┌┐·║
║·└┘·└┘·······└┘·└┘·║
║■······╔╗·╔╗······■║
╚═══════╝║ ║╚═══════╝
╔═══════╦══════════╗ 
║·······╨··········╚╗
║·╞╡·╞╗···┌──┐·╥·╥··║
║■····╨·╥·└──┘·║·╚╗·║
╠═╡·•···╨······║■·║·║
║···╔≡╗···╞╗·╥·╚╡·╨·║
║·╥·║ ║·╥··╨·║······║
║·║·║ ║·╠╡· ·║·╞══╡·║
║·╨·║:║·╨··╥·║······║
║···╚═╝···╞╝·╨·╔╡·╥·║
╠═╡·•···╥······║■·║·║
║■····╥·╨·┌──┐·║·╔╝·║
║·╞╡·╞╝···└──┘·╨·╨··║
║·······╥··········╔╝
╚═══════╩══════════╝ 
 ╔═════════════════╗ 
 ║■················║ 
═╝·╞══╡·╔══╡·╥·╥·•·╚═
 ·······╨····║·║■··· 
╦╡·╞╡·╥···╥·╞╝·╚═╡·╞╦
║·····║·╥·║········╥║
║·•·╞═╝·║·╚═╡·╞═╡·╞╝║
║·······║···········║
║·╞═╡·╞═╝╔═╡·╞═╡·╞╡·║
║·······╞╝··········║
║·╔═≡═╗····┌┐·╔╡·╞╗·║
║·║: :║·┌┐·└┘·║• •║·║
║·╚═══╝·└┘····╚╡·╞╝·║
║■·········┌┐······■║
╚══════════╛╘═══════╝
╔═══╦╝ ╚═════╝ ╚╦═══╗
║···╨···········╨···║
║·•■··•·╔═≡═╗·•··■•·║
║·┌┐·┌┐·║: :║·┌┐·┌┐·║
║·└┘·└┘·╚═══╝·└┘·└┘·║
║···················║
║·╞╡·╞╡·╞═══╡·╞╡·╞╡·║
║···················║
║·╞═╦═╡·╞═══╡·╞═╦═╡·║
║···║····· ·····║···║
║·╥·╨·╥·╞╗·╔╡·╥·╨·╥·║
║·║■··║··║·║··║··■║·║
║·╨·•·╚╡·╨·╨·╞╝·•·╨·║
║···················║
╚════╗ ╔═════╗ ╔════╝
