1 44x33 RGHOST=17 ROGHOST=2 RFRUIT=24.5 RTOP=13 RHERO=24.5 RMSG=19 CMSG=17 RMSG2=13 CMSG2=17 ABOUT="Inspired by Damon Chaplin/Paradox's 'Spook: Mighty Munchers' for 16-bit Atari computers"
┌──────────────────────────────────────────┐
│┌───────────────────┐┌───────────────────┐│
││···················││···················││
││·┌───┐·┌───┐·┌───┐·││·┌───┐·┌───┐·┌───┐·││
││·│┌─┐│·└──┐│·└──┐│·││·│┌──┘·│┌──┘·│┌─┐│·││
││■││ ││····└┘····└┘·└┘·└┘····└┘····││ ││■││
││·│└─┘│·┌┐····┌┐··········┌┐····┌┐·│└─┘│·││
││·└───┘·│└──┐·││·┌──────┐·││·┌──┘│·└───┘·││
││·······└───┘·└┘·└──┐┌──┘·└┘·└───┘·······││
││·┌┐·┌┐·············││·············┌┐·┌┐·││
││·││·│└───────────┐·││·┌───────────┘│·││·││
││·└┘·└────┐┌──────┘·└┘·└──────┐┌────┘·└┘·││
││·········││··················││·········││
│└───────┐·││·┌┐·┌─┐    ┌─┐·┌┐·││·┌───────┘│
╘═══════╡│·││·││·│┌┘    └┐│·││·││·│╞═══════╛
─────────┘·└┘·││·││      ││·││·└┘·└─────────
  ············└┘·││      ││·└┘············  
─────────┐·┌┐····││      ││····┌┐·┌─────────
╒═══════╡│·│└──┐·│└──────┘│·┌──┘│·│╞═══════╕
│┌───────┘·└┐┌─┘·└───┐┌───┘·└─┐┌┘·└───────┐│
││··········││·······││·······││··········││
││·┌──────┐·││·┌┐·┌┐·││·┌┐·┌┐·││·┌──────┐·││
││·│┌────┐│·└┘·││·││·││·││·││·└┘·│┌────┐│·││
││·└┘····││····└┘·└┘·└┘·└┘·└┘····││····└┘·││
││■···┌┐·││·┌┐·······  ·······┌┐·││·┌┐···■││
│└──┐·││·││·││·┌────────────┐·││·││·││·┌──┘│
│┌──┘·└┘·└┘·││·└─────┐┌─────┘·││·└┘·└┘·└──┐│
││··········││·······││·······││··········││
││·┌────────┘└─────┐·││·┌─────┘└────────┐·││
││·└───────────────┘·└┘·└───────────────┘·││
││········································││
│└────────────────────────────────────────┘│
└──────────────────────────────────────────┘
