6 15x17~1 RGHOST=7.5 ROGHOST=2 COGHOST=0 RFRUIT=9.5 RTOP=5.5 RHERO=11.5 RMSG=9 CMSG=5 RMSG2=5 CMSG2=5 READY="READY" GAMEOVER=" BYE " PLAYER1="P ONE" PLAYER2="P TWO" FLIP_TO=2 MORTAR_COLORS="\x02\x05\x0C\x03\x0F\x09" ABOUT="MyMan default maze layout (maze very reduced)"
╔═════════════╗
║·············║
║■╥·╔═════╗·╥■║
║·╨·║·····║·╨·║
║···╨ ╞═╡ ╨···║
╚═╗·       ·╔═╝
══╝·╥ ╔≡╗ ╥·╚══
   ·║ ║ ║ ║·   
══╗·╨ ╚═╝ ╨·╔══
╔═╝·       ·╚═╗
║■··╞╗·•·╔╡··■║
╠╡·╥·║· ·║·╥·╞╣
║··╨·╚═══╝·╨··║
║·╥·········╥·║
║·╨·╞═════╡·╨·║
║·············║
╚═════════════╝
╔═════╗ ╔═════╗
║·····║ ║·····║
║■╔═╡·╚╦╝·╞═╗■║
║·║····║····║·║
║·╨·╔╡ ╨ ╞╗·╨·║
║···║     ║···║
║·•·╨ ╔≡╗ ╨·•·║
║· ·  ║ ║  · ·║
║·•·╥ ╚═╝ ╥·•·║
║···║     ║···║
╠═╡·╚╡ • ╞╝·╞═╣
║······ ······║
║■╔═╡·┌─┐·╞═╗■║
║·║···│ │···║·║
║·╨·•·└─┘·•·╨·║
║·············║
╚═════════════╝
  ║·╚═════╝·║  
  ║·········║  
╔═╝·╥·╞═╡·╥·╚═╗
║···║·····║···║
║■•·╨ ╞═╡ ╨·•■║
║···       ···║
╚═╗·• ╔≡╗ •·╔═╝
  ║·  ║ ║  ·║  
╔═╝·• ╚═╝ •·╚═╗
║···       ···║
║■╥·╥ ╞═╡ ╥·╥■║
║·║·║·· ··║·║·║
║·║·╨·╞═╡·╨·║·║
║·║·········║·║
║·╨·╥·╞═╡·╥·╨·║
║···║·····║···║
╚═╗ ╠═════╣ ╔═╝
╔═════╗ ╔═════╗
║·····║ ║·····║
║·╔═╗·╚═╝·╔═╗·║
║·║■║·····║■║·║
║·╨·║ ╞═╡ ║·╨·║
║···║     ║···║
╚╗·┌╜ ╔≡╗ ╙┐·╔╝
 ║·││ ║ ║ ││·║ 
╔╝·└┘ ╚═╝ └┘·╚╗
║··         ··║
║·╞═╦═════╦═╡·║
║■··║·· ··║··■║
║·╥·╨·╞═╡·╨·╥·║
║·║·········║·║
║·╨·╥·╔═╗·╥·╨·║
║···║·║ ║·║···║
╚═══╩═╝ ╚═╩═══╝
╔═════╗ ╔═════╗
║·····║ ║·····║
║■╔═╡·╚╦╝·╞═╗■║
║·║····║····║·║
║·╨·╔╡ ╨ ╞╗·╨·║
║···║     ║···║
║·•·╨ ╔≡╗ ╨·•·║
║· ·  ║ ║  · ·║
║·•·╥ ╚═╝ ╥·•·║
║···║     ║···║
╠═╡·╚╡ • ╞╝·╞═╣
║······ ······║
║■╔═╡·┌─┐·╞═╗■║
║·║···│ │···║·║
║·╨·•·└─┘·•·╨·║
║·············║
╚═════════════╝
╔═════╗ ╔═════╗
║·····║ ║·····║
║·╔═╗·╚═╝·╔═╗·║
║·║■║·····║■║·║
║·╨·║ ╞═╡ ║·╨·║
║···║     ║···║
╚╗·┌╜ ╔≡╗ ╙┐·╔╝
 ║·││ ║ ║ ││·║ 
╔╝·└┘ ╚═╝ └┘·╚╗
║··         ··║
║·╞═╦═════╦═╡·║
║■··║·· ··║··■║
║·╥·╨·╞═╡·╨·╥·║
║·║·········║·║
║·╨·╥·╔═╗·╥·╨·║
║···║·║ ║·║···║
╚═══╩═╝ ╚═╩═══╝
