1 32x24 RMSG=13 CMSG=11 RMSG2=7 CMSG2=11 RGHOST=11 RTOP=7.5 RFRUIT=13.5 RHERO=17.5 ABOUT="Inspired by Henrik Hoexbroe/TITAN Kopenhagen's 'TITANman'"
╔══════════════╕╒══════════════╗
║··············││··············║
║■╞═══╡·╞════╡·└┘·╞════╡·╞═══╡■║
║······························║
╠═════╡·╞══════════════╡·╞═════╣
║······························║
║·╞════╡·╥ ╞════════╡ ╥·╞════╡·║
║········║            ║········║
╚══════╗·║ ╔═╡    ╞═╗ ║·╔══════╝
═══════╝·║ ║        ║ ║·╚═══════
        ·║ ║        ║ ║·        
═══════╗·║ ║        ║ ║·╔═══════
╔══════╝·║ ╚════════╝ ║·╚══════╗
║········║            ║········║
║·╔═══╦╡·╚╡ ╞══╕╒══╡ ╞╝·╞╦═══╗·║
║·║···║········││········║···║·║
║·║·╥·╨·╞════╡·└┘·╞════╡·╨·╥·║·║
║·╨·╨······················╨·╨·║
║·····╔══╡·╞═══╕╒═══╡·╞══╗·····║
╠═══╡·║········└┘········║·╞═══╣
║·····║·┌────┐····┌────┐·║·····║
║■╞═══╝·└────┘·┌┐·└────┘·╚═══╡■║
║··············││··············║
╚══════════════╛╘══════════════╝
