1 28x31 ABOUT="Inspired by 'Xen's Revenge', a maze hack by Jeff Morris"
╔═════╕╒═════╕╒═════╕╒═════╗
║·····└┘·····││·····└┘·····║
║·┌─┐····┌─┐·└┘·┌─┐····┌─┐·║
║■│ └──┐·│ │····│ │·┌──┘ │■║
║·└────┘·└─┘·┌┐·└─┘·└────┘·║
║············││············║
║·┌──┐·┌─────┘└─────┐·┌──┐·║
║·└──┘·│┌──────────┐│·└──┘·║
║······││··········││······║
╙────┐ ││ ┌──────┐ ││ ┌────╜
╓────┘ └┘ └──────┘ └┘ └────╖
║                          ║
║ ┌──┐ ┌┐ ╔══≡≡══╗ ┌┐ ┌──┐ ║
║ └─┐│ ││ ╨      ╨ ││ │┌─┘ ║
║  ·││ ││   ····   ││ ││·  ║
╙───┘│ ││ ╥      ╥ ││ │└───╜
╓────┘ ││ ╚══════╝ ││ └────╖
║······││          ││······║
║·┌──┐·││ ┌┐ ┌┐ ┌┐ ││·┌──┐·║
║·└──┘·└┘ └┘ ││ └┘ └┘·└──┘·║
║············││············║
║·┌──┐·┌─────┘└─────┐·┌──┐·║
║·└──┘·│┌──────────┐│·└──┘·║
║■·····││····  ····││·····■║
╙────┐·││·┌──────┐·││·┌────╜
╓────┘·││·└──┐┌──┘·││·└────╖
║······││····││····││······║
║·┌──┐·│└──┐·││·┌──┘│·┌──┐·║
║·└──┘·└───┘·└┘·└───┘·└──┘·║
║··························║
╚══════════════════════════╝
